足球是人民体育出版社出版的图书作者是何永超著1	足球是人民体育出版社出版的图书作者是何永超著1
老虎谍战电视剧暗算中的角色由王寅饰演1	老虎谍战电视剧暗算中的角色由王寅饰演1
恒星是张赫宣主唱的一首歌1	恒星是张赫宣主唱的一首歌1
进入某些活动场所的凭证也比喻参加某种赛事或活动的资格争夺参加世界杯决赛的	门票通常是由商业活动的主办方或者旅游景点的管理方负责发行制作销售并监管使用的一种有价票证如公园博物馆体育场等一般是一次性的而且需要花钱购买有时被称为入场券当然也可能是为了促销或答谢老客户等发行的免费门票
钱是1983年上映的美国剧情电影由罗伯特布列松执导克里斯琴佩蒂及马克厄恩斯特等主演钱讲述了一张500元法郎的假钞在很多人之间转手最后落到了一个叫伊文的年轻人手中在他使用这张钱时被发现并被捕入狱从而改变了他的命运	现金是由史蒂夫安德森执导的犯罪片克里斯海姆斯沃斯和肖恩宾等主演该片讲述了SamPhelan和爱妻Leslie在失业后面临支付抵押房贷的困难一天Sam发现一个内藏60多万的美元皮夹随后Pyke寻找到了Sam追回了部分款项这对夫妇已经花去了其中大概75万美元Pyke想要他们在5日内退还余款的故事
银行是由查理卓别林导演艾德娜珀薇安丝主演的一部影片	钱是罗伯特布列松执导的犯罪片克里斯蒂安佩蒂和VincentRisterucci出演该片讲述了小伙子伊万把自己的命运引向不可知的远方的故事
手机是由金汉珉执导金美贤编剧严泰雄朴勇宇主演的惊悚电影于2009年2月19日在韩国上映该片讲述了明星经纪人承珉在丢失手机后的128小时内经历的惊悚故事1	电话是由李聪贤执导朴智恩担任编剧全钟瑞朴信惠领衔主演的惊悚电影1影片讲述了金书妍和吴英淑这两个生活在不同时间线上的女子因为一通电话而发生关联的惊悚故事2该片于2020年11月27日在Netflix线上上映3
宝石是2015年现代出版社出版的图书1	珠宝是2019年中国林业出版社出版的图书1
类型是编程语言中的一个很重要的概念	种类拼音zhngli汉语词语指依据人物事物的品名性质或特点而分的类别种族1
新闻1也叫消息资讯是通过报纸电台广播电视台等媒体途径所传播信息的2一种称谓是记录社会传播信息反映时代的一种文体新闻概念有广义与狭义之分就其广义而言除了发表于报刊广播互联网电视上的评论与专文外的常用文本都属于新闻之列包括消息通讯特写速写有的将速写纳入特写之列等等3狭义的新闻则专指消息消息是用概括的叙述方式比较简明扼要的文字迅速及时地报道国内外新近发生的有价值的事实让别人了解每则新闻一般包括标题电头导语主体背景和结语六部分前四者是主要部分后二者是辅助部分标题导语主体必不可少写法上主要是叙述有时兼有议论描写评论等新闻是包含海量资讯的新闻服务平台真实反映每时每刻的重要事件可以通过查看新闻事件热点话题人物动态产品资讯等快速了解它们的最新进展4	报道是一个汉语词汇读音为bodo指通过报纸杂志广播电视或其他形式把新闻告诉群众或指用书面或广播电视形式发表的新闻稿1
街道为街与道的合称指城镇中的道路而且此类道路两边有连续不断的房屋建筑汉语意境中人口稠密区中有建筑连片区的道路尽管多被冠以街道路马路大道不论其主要功能是什么都可以被认为是街道对于具有良好基础设施与娱乐休闲功能的道路即使两边没有连片建筑设施也被认为是街道但对以车辆通行为主的普通公路和高速公路等很少人会当作街道在规划学领域街道也被看做建筑围合中的一个负空间	街区是城市规划城市设计中的一个重要因素人们通常提到的街区为城市街区在西方国家中例如美国1人口普查的最小颗粒度也是街区每一项人口普查内容都可以按照街区来进行统计因此在人口统计学中街区可以被称为人口统计街区在我国部分城市大型房地产项目被划分成若干街区乃是一个地产品牌一期二期分建而来在地产项目中通常是一个商业概念在城市中街区通常是被道路所包围的区域是城市结构的基本组成单位然而在郊区以及乡镇中道路并不会像城市那么密集因此人口统计街区就还会借助其他一些自然特征或人文特征来进行街区的划分与分割例如行政边界河流湖泊铁路山脉悬崖等对于世界中的绝大多数城市来说城市都是出于规划下而发展的道路通畅纵横交错因此街区的形状通常也是类正方形或长方形
街道汉语词汇拼音jido释义供人车通行的道路	大街拼音dji解释一般指城镇中路面较宽较为繁华的街道
书是一个汉字拼音sh是人类用来纪录一切成就的主要工具书本一般指装订成册的印刷有文字的纸张集合体也是人类交融感情传承知识获取经验的重要媒介对人类文明的发展与传承具有重要的意义是人类传播和记录知识的重要工具	图书馆是搜集整理收藏图书资料以供人阅览参考的机构早在公元前3000年就出现了图书馆图书馆有保存人类文化遗产开发信息资源参与社会教育等职能图书馆是社会记忆通常表现为书面记录信息的外存和选择传递机制换句话说图书馆是社会知识信息文化的记忆装置扩散装置1
书拼音sh是汉语通用规范一级字1最早见于甲骨文2本义作动词是书写记述的意思后引申为名词指简册典籍文书信函等基本信息栏来源3	纸汉语常用字一级字1读作zh最早见于秦简2本义是指漂洗丝絮时附着于漂器上的絮渣后指以丝为原料的缣帛在现代汉语中一般指用植物纤维制成的薄片也引申成量词基本信息栏参考资料3
医生钻研学习医学科学技术挽救生命以治病为业的人一般指临床医师按照卫生部卫健委医政部有关医疗卫生管理条例的法律法规主持医患沟通学术讨论新技术推广预后分析公众教育护理示教康复培训出院教育执行卫生防疫计生大病早期识别干预等法律政治责任承担部分课题研究等工作预防出生缺陷提高人口素质治病救人履行病情如实告知合理检查合理开药正确诊断积极治疗的责任提高医生职业风险和医疗事故安全法律意识避免误诊漏诊控制医源性继发损害纠正违章作业等法律责任通过定期临床理论考试技能考核培训能够熟练掌握临床必要的医学技能和必要的医学理论如影像学解剖学病理学医学遗传学药物化学康复医学生育保健学临床法医学等取得执业资格不得夸大病情吓唬病人延误时机造成事故要按照行业规范开展诊疗活动医生古代称大夫或郎中新中国成立后我国涌现了大量赤脚医生一度达到150多万名现在大夫一词在北方人中也常用在欧美医生普遍被称为Physician只有外科医生被称呼为Surgeon外科医生的法语称呼为DecinMedusan德语是Arztarutsuto但在英联邦英国外科医生今天还以密司脱称呼	护士被称为白衣天使1914年钟茂芳在第一次中华护士会议中提出将英文Nurse译为护士大会通过工作时必须脱下便服穿护士服护士必须按照卫健委相关法律条文标准和护理行业规范执行开展相应的护理项目观察病人体表体重情况了解病人病情配合医生治疗及时处理医疗纠纷防止医疗事故发生并从生理心理社会文化和精神诸方面日常活动用药和安全等问题从事与医疗有关的全项临床操作或单项专项护理活动如机械排痰穿刺输液入院宣教出院指导执行医嘱铺床换被安全提示取药配药摆药病情速记资料入卷采集标本责任交接观察病情医疗废物毁形消毒医疗垃圾管理分类收集建议学习培训送标送检引导病员夜间查房设备点检设备保洁整理内务5s实施出院核算整理病历宣贯医嘱护理示教抢救急救按时巡查异常报告物品发放电脑登记维修维护测量体温技能考核病员分类驱除四害病员点评等必要的日常护理活动经执业注册取得护士执业证书依照本条例规定从事护理活动履行保护人类生命减轻病员痛苦增进健康职责的卫生技术人员2020年8月1日起护士可依照权限通过机构端个人端进行信息维护符合生成条件后予以制发电子证照1截至2021年底中国500多万护士中男性护士比例占3这比2012年的18提高了不少每千人口的注册护士数量也从2012年的185人增加到2021年的356人6
虎学名Pantheratigris俗称老虎是哺乳纲大型猫科动物是亚洲的特有种类原产地主要是东北亚和东南亚虎是种高度进化的猎食动物也是自然界生态中不可或缺的一环成年虎的身长可达225米尾长1米重达90220公斤在它庞大的体型与有力肌肉之外它们最显著的特征就是在白色或橘红色的毛皮上有黑色垂直的条纹它们下半部的颜色较淡凶猛至极力量极大有森林之王百兽之王之称古称南山白额王出处宋苏辙湖阴曲老虎穴中卧猎夫不敢窥元王恽赵邈龊虎图行耽耽老虎底许来抱石踞坐何雄哉	动物Animal是生物的一个种类它们一般以有机物为食能感觉可运动能够自主运动或能够活动之物包括人根据化石研究地球上最早出现的动物源于海洋早期的海洋动物经过漫长的地质时期逐渐演化出各种分支丰富了早期的地球生命形态在人类出现以前史前动物便已出现并在各自的活动期得到繁荣发展后来它们在不断变换的生存环境下相继灭绝但是地球上的动物仍以从低等到高等从简单到复杂的趋势不断进化并繁衍并有了如今的多样性科学家们把现存的人类已知的动物根据体内有无脊柱分为无脊椎动物和脊椎动物两大种类科学家已经鉴别出46900多种脊椎动物包括鲨鱼鳐鱼等软骨鱼类动物鲤鱼黄鱼草鱼等硬骨鱼类动物青蛙娃娃鱼等两栖类动物蛇蜥蜴等爬行类动物鸡鸽子麻雀等鸟类动物以及猴子红熊猫等哺乳类动物科学家们还发现了130多万种无脊椎动物这些动物中多数是昆虫昆虫中多数是甲虫海绵蚯蚓乌贼牡蛎红海星水母蜘蛛珊瑚虫放射虫蛔虫猪肉绦虫沙蚕蜗牛蛞蝓等都属于无脊椎动物动物界所有成员的身体都是由细胞组成的异养有机体
战争是一种集体集团组织派别国家政府互相使用暴力攻击杀戮等行为是敌对双方为了达到一定的政治经济领土等目的而进行的武装战斗由于触发战争的往往是政治家而非军人因此战争亦被视为政治和外交的极端手段广义来说并非只有人类才有战争蚂蚁和黑猩猩等生物也有战争行为战争是政治集团之间民族部落之间国家联盟之间的矛盾最高的斗争表现形式是解决纠纷的最暴力的手段是在自然界解决问题的办法手段之一通常被认为是原始社会才会使用的方法由于侵略战争给人类造成巨大的伤害在现代人类社会不被认可	部队army是指军队中团及团以上建制单位的通称军队中团及团以上建制单位的通称授予番号代号军旗设有领导指挥机关编有作战和战斗勤务保障单位也泛指军队
虎学名Pantheratigris俗称老虎是哺乳纲大型猫科动物是亚洲的特有种类原产地主要是东北亚和东南亚虎是种高度进化的猎食动物也是自然界生态中不可或缺的一环成年虎的身长可达225米尾长1米重达90220公斤在它庞大的体型与有力肌肉之外它们最显著的特征就是在白色或橘红色的毛皮上有黑色垂直的条纹它们下半部的颜色较淡凶猛至极力量极大有森林之王百兽之王之称古称南山白额王出处宋苏辙湖阴曲老虎穴中卧猎夫不敢窥元王恽赵邈龊虎图行耽耽老虎底许来抱石踞坐何雄哉	主要以肉类食物为主的一类动物英文名称carnivore肉食类动物亦称Meateater四肢强劲灵活性非常强牙齿尖锐而有力具食肉齿裂齿即上颌最后1枚前臼齿和下颌最前1枚臼齿上裂齿两个大齿尖和下裂齿外侧的两个大齿尖在咬合时像尖锐的刺刀可将韧带软骨切断大齿异常粗大长而尖颇锋利起刺穿作用野外攻击性强速度快
男孩是Lu1演唱的歌曲收录于2015年7月1日发行的男孩aportraitintime专辑中	小伙子是SupperMoment演唱的一首中文歌曲收录于专辑小伙出城记1
自然从最广泛的意义上说是自然的物理的物质的世界或宇宙自然可以指物理世界的现象也可以指一般的生命对自然的研究即使不是科学也是很大的一部分尽管人类是自然的一部分但人类活动通常被理解为与其他自然现象不同的类别这个词的各种用法中自然通常指的是地质学和野生动物自然可以指有生命的植物和动物的一般领域在某些情况下可以指与无生命物体相关的过程特定类型的事物存在的方式和它们自己的变化例如地球的天气和地质它通常被用来表示自然环境或荒野野生动物岩石森林以及一般来说那些没有被人类干预实质性改变的东西或者尽管人类干预仍然存在的东西例如人造物体和人类互动通常不被视为自然的一部分除非被限定为例如人性或整个自然这个可以找到的关于自然事物的更传统的概念意味着自然和人工之间的区别人工存在被理解为由人类意识或人类思想产生的东西根据特定的上下文术语自然也可能与非自然或超自然区分开来3	人类生存的空间及其中可以直接或间接影响人类生活和发展的各种自然因素称为环境1对人的心理发生实际影响的整个生活环境也称为环境更多称为心理环境
对于判例必须分别来看在民法法系判例是非正式的法律渊源除了个别情况外理论上不承认判例具有约束力在普通法法系判例是正式的法律渊源即判例法公共政策是有关必须达到集体目的或目标的一种政治决定这种决定一般来说旨在改善经济政治或者社会的境况或旨在促进整个社会的某种集体目标的实现事物性质实际上是一种知识或人们对事物内在规律的认识1	例子是汉语词汇拼音lzi意思是客观存在的旧规惯例也指性质类同的事物中具有代表性的单个多用于解释说明
法律是中国专业学位研究生培养制度中的一种专业属于法学类专业的一种社会业余人士也经常习惯的将法学专业称之为法律专业法律专业培养系统掌握法学知识熟悉中国法律和党的相关政策能在国家机关事业单位和社会团体特别是能在立法机关行政机关司法机关检察机关审判机关仲裁机构和法律服务机构以及涉外涉侨等部门从事法律工作的高级专门人才	律师lawyer是指接受委托或者指定为当事人提供诉讼代理或者辩护业务等法律服务的人员律师须通过法律职业资格考试并依法取得律师执业证书方可执业按照工作性质划分律师可分为专职律师与兼职律师按照业务范围划分律师可分为民事律师刑事律师和行政律师按照服务对象和工作身份划分律师可分为社会律师公司律师和公职律师律师业务主要分为诉讼业务与非诉讼业务2021年8月20日十三届全国人大常委会第三十次会议表决通过中华人民共和国法律援助法基层法律服务所负有依法提供法律援助的义务6
老虎是2018年中国书籍出版社出版的图书作者是崔钟雷1	生物是2018年河南大学出版社出版的图书1
钱是1983年上映的美国剧情电影由罗伯特布列松执导克里斯琴佩蒂及马克厄恩斯特等主演钱讲述了一张500元法郎的假钞在很多人之间转手最后落到了一个叫伊文的年轻人手中在他使用这张钱时被发现并被捕入狱从而改变了他的命运	现金是由史蒂夫安德森执导的犯罪片克里斯海姆斯沃斯和肖恩宾等主演该片讲述了SamPhelan和爱妻Leslie在失业后面临支付抵押房贷的困难一天Sam发现一个内藏60多万的美元皮夹随后Pyke寻找到了Sam追回了部分款项这对夫妇已经花去了其中大概75万美元Pyke想要他们在5日内退还余款的故事
教授是一个汉语词语读音为jioshu现解释是高等教育机构的教师的最高级学衔古时设置在地方官学中的学官对私塾老师的敬称讲解传授知识技能	博士古为官名秦汉时是掌管书籍文典通晓史事的官职后成为学术上专通一经或精通一艺从事教授生徒的官职如明代初期朱允炆曾封方孝孺为文学博士等1
环境是2019年中国农业出版社出版的图书1	生态是2001年5月中国财经出版社出版的图书作者是俄奇热夫斯基宋祖敏该书给讲述的是关于生态学生态环境等方面有益的知识1
虎学名Pantheratigris英文名Tiger是哺乳纲的大型猫科动物毛色浅黄或棕黄色满身黑色横纹头圆耳短耳背面黑色中央有一白斑甚显著四肢健壮有力尾粗长具黑色环纹尾端黑色共有九个亚种各亚种之间的体型和形态差异很大西伯利亚虎最大雄性体长可达37米体重423千克苏门答腊虎是最小的活亚种雄虎体长234米体重136千克老虎是典型的山地林栖动物由南方的热带雨林常绿阔叶林以至北方的落叶阔叶林和针阔叶混交林都能很好的生活虎常单独活动只有在繁殖季节雌雄才在一起生活无固定巢穴多在山林间游荡寻食能游泳虎多黄昏活动白天多潜伏休息没有惊动则很少出来虎的活动范围较大在北方日寻食活动范围可达数十公里在南方因食物较多则活动距离较短发情交配期一般在11月至翌年2月份发情期间虎的叫声特别响亮能达2千米远怀孕期105天左右每产15仔通常2仔新生虎仔重约1千克哺乳期56个月雌虎和幼仔在一起生活23年在此期间雌虎不发情交配故在自然条件下雌虎要每隔23年才能繁殖一次雌虎3年龄时性成熟雄虎要更晚些虎的寿命一般2025年由于人类的猎杀和野外栖息地碎片化虎成为珍稀濒危物种被列为濒危野生动植物种国际贸易公约CITES附录级保护动物世界自然保护联盟濒危物种红色名录IUCN濒危动物2016年调查显示全球野生虎的数量为3890只	猫科动物Felidae是哺乳纲食肉目猫科动物下的动物分为2亚科即猫亚科和豹亚科共有14属38种体型中大躯体均匀四肢中长趾行性头大而圆吻部较短视听嗅觉均很发达犬齿及裂齿极发达上裂齿具三齿尖下裂齿具2齿尖臼齿较退化齿冠直径小于外侧门齿高度皮毛柔软常具显著花纹前足5趾后足4趾爪锋利可伸缩猎豹属爪不能完全缩回尾一般较发达猫亚科动物爪能伸缩体型一般较小不发出吼声共有12属豹亚科爪能伸缩一般体型较大能发出吼声有2属猫科动物多数善攀缘及跳跃大多喜独居肉食常以伏击方式捕杀其他温血动物分布于欧亚大陆非洲美洲的寒带到热带地区由野猫Felissilvestris驯化来的家猫Fscatus已被人为带到全世界很多成为当地入侵物种
行星是一本2022年人民邮电出版社出版的图书作者是英布赖恩考克斯英安德鲁科恩1	星系是一本2022年北京科学技术出版社出版的图书作者是荷霍弗特席林1
心理学是一门研究人类心理现象及其影响下的精神功能和行为活动的科学兼顾突出的理论性和应用实践性心理学包括基础心理学与应用心理学其研究涉及知觉认知情绪思维人格行为习惯人际关系社会关系人工智能IQ性格等许多领域也与日常生活的许多领域家庭教育健康社会等发生关联心理学一方面尝试用大脑运作来解释个体基本的行为与心理机能同时心理学也尝试解释个体心理机能在社会行为与社会动力中的角色另外它还与神经科学医学哲学生物学宗教学等学科有关因为这些学科所探讨的生理或心理作用会影响个体的心智实际上很多人文和自然学科都与心理学有关人类心理活动其本身就与人类生存环境密不可分心理学家从事基础研究的目的是描述解释预测和影响行为应用心理学家还有第五个目的提高人类生活的质量这些目标构成了心理学事业的基础心理学符号在希腊语里是灵魂的意思后来变成英文psyche	学科有以下三种含义按照学问的性质依据学术的性质而划分的科学门类如自然科学中的物理学化学社会科学中的历史学语言学学校教学的科目如语文数学英语军事训练或体育训练中的各种理论知识性的科目区别于术科第一种含义学术分类指一定科学领域或一门科学的分支如自然科学中的1110数学120信息科学与系统科学130力学140物理学农业科学中的210农学220林学230畜牧兽医科学学科是与知识相联系的一个学术概念是A自然科学B农业科学C医药科学D工程与技术科学E人文与社会科学五大科学知识系统也有自然社会人文三大科学学科之说知识子系统的集合概念第二种含义教学科目指义务教育中等职业教育高等教育等教学活动的课程科目是中小学学位授予单位等教育部门对教师教学人才培养学位授予的科目分类与界定并用于学科建设和教育统计分类等工作学科建设中学科的含义侧重后者但与第一个含义也有关联第三种含义理论知识指在军事体育等体能训练中的各种知识的科目不同于技术性的术科
峡谷是指谷坡陡峻深度大于宽度的山谷它通常发育在构造运动抬升和谷坡由坚硬岩石组成的地段当地面抬升速度与下切作用协调时最易形成峡谷我国长江流域的三峡是世界闻名的大峡谷它由一系列峡谷组成一个长达788公里的峡谷段在黄河干流上也分布着许多巨大的峡谷如刘家峡黑山峡青铜峡等它是修建水库大坝的理想坝址地段我国解放后在许多峡谷上已兴建许多大型水坝以综合开发利用水利资源1	景观一般意义上是指一定区域呈现的景象即视觉效果这种视觉效果反映了土地及土地上的空间和物质所构成的综合体是复杂的自然过程和人类活动在大地上的烙印生态学上景观是指由相互作用的拼块或生态系统组成以相似的形式重复出现的一个空间异质性区域是具有分类含义的自然综合体俄国地理学家把生物和非生物的现象都作为景观的组成部分这也为地理学与生态学的融合交叉打下了基础中国大百科全书地理学1990概括了地理学中对景观的几种理解某一区域的综合特征包括自然经济文化诸方面一般自然综合体区域单位相当于综合自然区划等级系统中最小的一级自然区任何区域单位
液体Liquid是三大物质形态之一它没有确定的形状往往受容器的影响但它的体积在压力及温度不变的环境下是固定不变的液体分子间的距离较远分子运动也较剧烈分子间的吸引力较小增温或减压一般能使液体汽化成为气体	水化学式为H2O是由氢氧两种元素组成的无机物无毒可饮用在常温常压下为无色无味的透明液体被称为人类生命的源泉是维持生命的重要物质也叫氧化氢水是地球上最常见的物质之一地球表面约有71被水覆盖它是包括无机化合人类在内所有生命生存的重要资源也是生物体最重要的组成部分它在空气中含量虽少但却是空气的重要组分1纯水导电性十分微弱属于极弱的电解质日常生活中的水由于溶解了其他电解质而有较多的阴阳离子才有较为明显的导电性12022年9月中国科学家发现嫦娥五号矿物表层中存在大量的太阳风成因水16
计算机computer俗称电脑是现代一种用于高速计算的电子计算机器可以进行数值计算又可以进行逻辑计算还具有存储记忆功能是能够按照程序运行自动高速处理海量数据的现代化智能电子设备由硬件系统和软件系统所组成没有安装任何软件的计算机称为裸机可分为超级计算机工业控制计算机网络计算机个人计算机嵌入式计算机五类较先进的计算机有生物计算机光子计算机量子计算机等计算机发明者约翰冯诺依曼计算机是20世纪最先进的科学技术发明之一对人类的生产活动和社会活动产生了极其重要的影响并以强大的生命力飞速发展它的应用领域从最初的军事科研应用扩展到社会的各个领域已形成了规模巨大的计算机产业带动了全球范围的技术进步由此引发了深刻的社会变革计算机已遍及一般学校企事业单位进入寻常百姓家成为信息社会中必不可少的工具计算机的应用在中国越来越普遍改革开放以后中国计算机用户的数量不断攀升应用水平不断提高特别是互联网通信多媒体等领域的应用取得了不错的成绩1996年至2009年计算机用户数量从原来的630万增长至6710万台联网计算机台数由原来的29万台上升至5940万台互联网用户已经达到316亿无线互联网有67亿移动用户其中手机上网用户达117亿为全球第一位	软件中国大陆及香港用语台湾称作软体英文software是一系列按照特定顺序组织的计算机数据和指令的集合一般来讲软件被划分为系统软件应用软件和介于这两者之间的中间件软件并不只是包括可以在计算机这里的计算机是指广义的计算机上运行的电脑程序与这些电脑程序相关的文档一般也被认为是软件的一部分简单的说软件就是程序加文档的集合体另也泛指社会结构中的管理系统思想意识形态思想政治觉悟法律法规等等
电影是范晓萱演唱的一首歌曲收录在范晓萱2009发行的赤子专辑中	明星是梁朝伟演唱的歌曲收录于专辑风沙中
虎学名Pantheratigris俗称老虎是哺乳纲大型猫科动物是亚洲的特有种类原产地主要是东北亚和东南亚虎是种高度进化的猎食动物也是自然界生态中不可或缺的一环成年虎的身长可达225米尾长1米重达90220公斤在它庞大的体型与有力肌肉之外它们最显著的特征就是在白色或橘红色的毛皮上有黑色垂直的条纹它们下半部的颜色较淡凶猛至极力量极大有森林之王百兽之王之称古称南山白额王出处宋苏辙湖阴曲老虎穴中卧猎夫不敢窥元王恽赵邈龊虎图行耽耽老虎底许来抱石踞坐何雄哉	美洲豹学名PantheraoncaLinnaeus1758又叫美洲虎是现存第三大的猫科动物体重35150千克最大亚种雄性亚马孙美洲豹平均体重为98千克咬力可达1250磅是生活在中南美洲的一种大型猫科动物它身上的花纹比较像豹但整个身体的形状又更接近于虎在猫科动物中美洲豹的体型仅次于狮虎野外寿命约18年人工饲养的历史达20多年列入世界自然保护联盟濒危物种红色名录IUCN2021年近危NT
英里英制长度单位英制是一种使用于英国其前殖民地和英联邦国家非正式标准化的单位制从官方而言它只应用于美国利比里亚和缅甸而其他国家或地区则使用国际单位制即米制又称为公制而英国已于1995年完成了到国际单位制的转换	千米拼音是qinm汉语词语意思是指长度单位俗称公里英文用kmkilometer表示
虎学名Pantheratigris俗称老虎是哺乳纲大型猫科动物是亚洲的特有种类原产地主要是东北亚和东南亚虎是种高度进化的猎食动物也是自然界生态中不可或缺的一环成年虎的身长可达225米尾长1米重达90220公斤在它庞大的体型与有力肌肉之外它们最显著的特征就是在白色或橘红色的毛皮上有黑色垂直的条纹它们下半部的颜色较淡凶猛至极力量极大有森林之王百兽之王之称古称南山白额王出处宋苏辙湖阴曲老虎穴中卧猎夫不敢窥元王恽赵邈龊虎图行耽耽老虎底许来抱石踞坐何雄哉	哺乳动物是动物世界中形态结构最高等生理机能最完善的动物与其他动物相比哺乳动物最突出的特征在于胎生以及其幼崽由母体分泌的乳汁喂养长大哺乳动物大都长有皮毛以保持体温的恒定适应各种复杂的生存环境哺乳动物具有比较发达的大脑因而能产生比其他动物更为复杂的行为并能不断地改变自己的行为以适应外界环境的变化世界上现存的哺乳动物有4000多种虽然它们都已经高度进化但仍具有很多共性几乎所有的哺乳动物都是温血动物体温基本恒定身上披有毛发以保护身体隔绝冷热等等
由日本漫画家岸本齐史著作的漫画火影忍者及其作品中的角色海鲜	龙虾是日本漫画家岸本齐史著作的漫画火影忍者及其作品中的角色
精神病院是一个比较特殊的专科医院收治心理科患者重度抑郁症等	疯人院又称精神病院医院服务对象主要为精神病人各类急慢性精神病神经症心理障碍患者一般也到此类医院进行治疗
钱是由朴努利执导柳俊烈刘智泰赵宇镇金宰英主演的犯罪电影于2019年3月20日在韩国上映1该片改编自同名小说讲述的是想成为富翁而来到汝矣岛的新晋股票经纪人遇到汝矣岛最高作战设计师后发生的一系列关于金钱诱惑的故事2	财产Possessions是一部法国剧集2020年12月23日入选综艺杂志评选出2020年15部最佳国际剧集榜单1
脑卒中cerebralstroke又称中风脑血管意外cerebralvascularaccidentCVA是一种急性脑血管疾病是由于脑部血管突然破裂或因血管阻塞导致血液不能流入大脑而引起脑组织损伤的一组疾病包括缺血性和出血性卒中缺血性卒中的发病率高于出血性卒中占脑卒中总数的6070颈内动脉和椎动脉闭塞和狭窄可引起缺血性脑卒中年龄多在40岁以上男性较女性多严重者可引起死亡出血性卒中的死亡率较高调查显示城乡合计脑卒中已成为我国第一位死亡原因也是中国成年人残疾的首要原因脑卒中具有发病率高死亡率高和致残率高的特点不同类型的脑卒中其治疗方式不同由于一直缺乏有效的治疗手段认为预防是最好的措施其中高血压是导致脑卒中的重要可控危险因素因此降压治疗对预防卒中发病和复发尤为重要应加强对全民普及脑卒中危险因素及先兆症状的教育才能真正防治脑卒中	医院Hospital一词来自拉丁文原意为客人因为一开始设立时是供人避难还备有休息间使来者舒适有招待意图后来才逐渐成为满足人类医疗需求提供医疗服务的专业机构收容和治疗病人的服务场所医院是指按照法律法规和行业规范为病员开展必要的医学检查治疗措施护理技术接诊服务康复设备救治运输等服务以救死扶伤为主要目的的医疗机构其服务对象不仅包括有症状的病员和伤员也包括不能自理或活动受限有医疗护理依赖的老年人法医评定有医疗护理依赖或病情不稳定需要长期康复经常观察检查的重度病伤员或有其他特定的情况和人群如健康人如孕妇产妇新生儿以及完全健康的人如来医院进行体格检查或口腔清洁的人最初设立时是供人避难还备有娱乐节目使来者舒适有招待意图后来才逐渐成为收容和治疗病人的专门机构中华人民共和国2021年国民经济和社会发展统计公报显示2021年末年末全国共有医院医院36570个78
海鲜hoisin又称海产食物海鲜隔夜后易产生蛋白质降解物7包括鱼类虾类蟹类贝类软体类等品类虽然海带这类海洋生物也常是被料理成食物但是海鲜主要还是针对动物制成的料理为主狭义上只有新鲜的海产食物才能称为海鲜海鲜的分类有活海鲜冰鲜海鲜冷冻海鲜干海鲜	食物英文Food是指能够满足机体正常生理和生化能量需求并能延续正常寿命的物质对人体而言能够满足人的正常生活活动需求并利于寿命延长的物质称之为食物食物通常是由碳水化合物脂肪蛋白质水构成能够藉进食或是饮用为人类或者生物提供营养或愉悦的物质食物的来源可以是植物动物或者其他界的生物例如真菌亦或发酵产品像是酒精人类借由采集耕种畜牧狩猎渔猎等许多种不同的方式获得食物
电视是华艺出版社出版的图书作者是庸人1	电影是2002年湖南文艺出版社出版的图书1
杯子是一种专门盛水的器皿其主要功能都是用来饮酒或饮茶一般容积不大或在古代喝茶的杯子被称为盖碗基本器型大多是直口或敞口口沿直径与杯高近乎相等有平底圈足或高足考古资料表明最早的杯始见于新石器时代无论是在仰韶文化龙山文化还是河姆渡文化遗址中都见有陶制杯的存在这一时期杯型最为奇特多样带耳的有单耳或双耳杯带足的多为锥形三足杯觚形杯高柄杯等等根据制作材料不同可以分为玻璃杯塑料杯陶瓷杯木杯等2	餐具指用餐时直接接触食物的非可食性工具用于辅助食物分发或摄取食物的器皿和用具市场上还出现了许多一次性的餐具这种餐具对环境不好也有一些可降解材料制作的餐具餐具包括成套的有金属器具陶瓷餐具茶具酒器玻璃器皿纸制器具塑料器具以及五花八门用途各异的各种容器类工具如碗碟杯壶等和手持用具如筷刀叉勺吸管签棒等及等用具
网球SmashTennis是一款拥有漂亮3D图形和逼真物理场景的体育竞技类游戏你只需要滑动你的手指触球就会感觉像是你真正在打网球1	球拍是用来打球的拍子分为拍面拍柄等
树是具有木质树干及树枝的植物可存活多年一般将乔木称为树主干植株一分枝距离地面较高可以形成树冠树有很多种树木是木本植物的总称包含乔木灌木和木质藤本之分树木主要是种子植物蕨类植物中只有树蕨为树木中国约有8000种树木分为榕树杨树柳树柏树等俗语中也有将比较大的灌木称为树的如石榴树茶树等树在减少土地侵蚀及调整气候上相当的重要树可以从空气中吸收二氧化碳将大量的碳储存在组织内树木和森林是许多物种的栖息地热带雨林是世界上生物多样性最丰富的地方之一树可以提供遮阴及保护木材可供建筑用木炭可以用来加热及烹煮果子可以用来作为食物在世界各地的森林面积正在下降目的是要增加可以农业使用的土地由于树的长寿及实用在许多神话中也有树的出现2015年有报告估计地球上共有约3万亿棵大树当中约139万亿棵在热带和亚热带6100亿棵在温带7400亿棵在围绕北极的北方森林与11000年前比较人类活动已导致树的数量减少一半现时人类每年除去约150亿棵树只植回约50亿棵	森林包括乔木林竹林和国家特别规定灌木林地按用途可以分为防护林特种用途林用材林经济林和能源林原薪炭林1以木本植物为主体的生物群落是集中的乔木与其它植物动物微生物和土壤之间相互依存相互制约并与环境相互影响从而形成的一个生态系统的总体它具有丰富的物种复杂的结构多种多样的功能森林被誉为地球之肺
杯子是一种专门盛水的器皿其主要功能都是用来饮酒或饮茶一般容积不大或在古代喝茶的杯子被称为盖碗基本器型大多是直口或敞口口沿直径与杯高近乎相等有平底圈足或高足考古资料表明最早的杯始见于新石器时代无论是在仰韶文化龙山文化还是河姆渡文化遗址中都见有陶制杯的存在这一时期杯型最为奇特多样带耳的有单耳或双耳杯带足的多为锥形三足杯觚形杯高柄杯等等根据制作材料不同可以分为玻璃杯塑料杯陶瓷杯木杯等2	物品汉语词语读音为wpn是生产办公生活领域常用的一个概念泛指各种东西或零星的物品1也泛指经济活动中涉及到实体流动的物质资料
传统意义上的性交一般指的是勃起状态的阴茎跟阴道互相接合及在内摩擦的过程又称阴茎阴道性交1但近些年来也有人们将肛交口交指交等视为性交的不同形式2一般来说性交的目的包括生殖与繁衍愉悦享乐加强情感纽带等对身心健康都具有一定积极效应但同时性交存在发生性传播感染非意愿妊娠性猝死的风险需要通过使用安全套等措施落实安全性交与生育控制性交主要包括兴奋期持续期高潮期消退期四个性反应周期3并可通过体位的变化或性玩具的使用等生理要素动机或情感等心理要素促进性刺激部分人群可能存在着性唤起障碍性高潮障碍性交疼痛障碍关于性交的已有研究主要从法律媒体文化道德宗教等角度展开另外我国中华人民共和国刑法2020修正中华人民共和国未成年人保护法2020修订等法律法规与政策文件对性交及其相关行为作了定罪或原则说明儿童权利公约ConventionontheRightsoftheChild1989消除对妇女一切形式歧视公约TheConventionontheEliminationofAllFormsofDiscriminationagainstWomen1979等国际文件要求对妇女与儿童加以保护使其免遭性方面的剥削与侵害年轻人了解关于性交的知识建立对于性交的全面正确认识学习有关性交的个人决策技能指导如何避免和拒绝不安全的性交行为有利于维护自己和他人的健康与福祉这些都是全面性教育的重要内容	性现代汉语规范一级字常用字1读音为xng现在所知最早的性字为金文说文解字人之阳气性善者也从心生声2性字本义为人或事物本身所具有的能力作用等引申指性质思想感情等方面的表现又引申指男女或雌雄的特质又引申指有关生物生殖的等等3
美元UnitedStatesdollar货币缩写USDISO4217货币代码USD符号USA是美利坚合众国萨尔瓦多共和国巴拿马共和国厄瓜多尔共和国东帝汶民主共和国马绍尔群岛共和国密克罗尼西亚联邦基里巴斯共和国和帕劳共和国的法定货币流通的美元纸币是自1929年以来发行的各版钞票1792年美国铸币法案通过后出现当前美元的发行是由美国联邦储备系统控制自1913年起美国建立联邦储备制度发行联邦储备券现行流通的钞票中99以上为联邦储备券美元的发行主管部门是国会具体发行业务由联邦储备银行负责办理在二战以后欧洲大陆国家与美国达成协议同意使用美元进行国际支付此后美元作为储备货币在美国以外的国家广泛使用并最终成为国际货币1截止2021年12月16日晚10点里拉对美元汇率已经超过156创下新低2021年以来里拉对美元贬值幅度超过503	日元日语円日语罗马音en英语Yen其纸币称为日本银行券是日本的法定货币日元也经常在美元和欧元之后被当作储备货币日元是日本的货币单位名称创设于1871年5月1日1897年日本确立金本位含金量定为075克1953年5月含金量宣布为000246853克1988年3月31日彻底废除金本位制发行中的纸币有10002000500010000日元四种1硬币有151050100500日元六种面额比较特别的是日元纸币的发行者是日本银行日本银行日本银行券日元硬币的发行者是日本政府日本国同时与人民币不同的是日元硬币不具有无限法偿能力所以原则上在一次交易中同一面值硬币法定使用上限为20枚即硬币原则上最大支付能力为1円20枚5円20枚10円20枚50円20枚100円20枚500円20枚13320円超出部分商家有权依法拒收2019年4月9日日本政府财务相麻生太郎正式宣布将在2024年度的上半年更换纸币图案推出1万日元5000日元和1000日元新纸币正面将分别使用涩泽荣一津田梅子北里柴三郎的人物肖像2
哈佛大学HarvardUniversity简称哈佛位于美国马萨诸塞州波士顿都市区剑桥市的一所私立研究型大学12常春藤盟校全球大学高研院联盟成员1378哈佛大学建立于1636年最早由马萨诸塞州殖民地立法机关创建初名新市民学院34为了纪念在成立初期给予学院慷慨支持的约翰哈佛牧师学校于1639年3月更名为哈佛学院HarvardCollege1780年哈佛学院正式改称哈佛大学34哈佛大学由十所学院以及一个高等研究所构成157该校还负责管理运行哈佛史密松森天体物理中心麻省总医院波士顿儿童医院等机构811截至2018年哈佛共有18位菲尔兹奖得主14位图灵奖得主84	耶鲁大学YaleUniversity简称耶鲁Yale坐落于美国康涅狄格州纽黑文是世界著名的私立研究型大学全美第三古老的高等学府14美国大学协会的14所创始院校之一也是著名的常春藤联盟成员57耶鲁大学最初由康涅狄格州公理会教友于1701年创立1716年迁至康涅狄格州的纽黑文NewHaven13耶鲁大学作为美国最具影响力的私立大学之一是美国历史上建立的第三所大学其本科生院与哈佛大学普林斯顿大学齐名历年来共同角逐美国大学本科生院美国前三名位列201920年USNews美国大学本科排名第3138耶鲁大学图书馆拥有1500万册藏书在美国大学图书馆系统中排名第二1113耶鲁校园的260座建筑物涵盖各个历史时期的设计风格被誉为美国最美丽的城市校园1415耶鲁大学的教授阵容课程安排教学设施方面堪称世界一流34截至2020年10月耶鲁大学校友教授及研究人员中共产生了65位诺贝尔奖得主世界第十一5位菲尔兹奖得主世界第十二以及3位图灵奖得主世界第十六1027此外耶鲁大学还走出了包括威廉杰斐逊克林顿乔治赫伯特沃克布什在内的5位美国总统以及19位美国最高法院大法官16位亿万富豪等1392526202122年度耶鲁大学位列泰晤士高等教育世界大学排名世界第8名17CWUR世界大学排名世界第10位28USNews世界大学排名世界第12名18软科世界大学学术排名世界第11名16QS世界大学排名世界第14名23
虎学名Pantheratigris俗称老虎是哺乳纲大型猫科动物是亚洲的特有种类原产地主要是东北亚和东南亚虎是种高度进化的猎食动物也是自然界生态中不可或缺的一环成年虎的身长可达225米尾长1米重达90220公斤在它庞大的体型与有力肌肉之外它们最显著的特征就是在白色或橘红色的毛皮上有黑色垂直的条纹它们下半部的颜色较淡凶猛至极力量极大有森林之王百兽之王之称古称南山白额王出处宋苏辙湖阴曲老虎穴中卧猎夫不敢窥元王恽赵邈龊虎图行耽耽老虎底许来抱石踞坐何雄哉	动物群是分布于一定地区环境或时代历史上形成起来的各种动物的总体在古生物学中常按动物类别分布地区或地史时代等进行划分命名其范围大小并无一定按分布地区划分的如华北型动物群东南型动物群按地史时代划分的如寒武纪动物群早寒武世动物群按生物类别划分的如珠角石动物群直角石动物群等1
海鲜是海天出版社出版的图书作者是香港万里机构	海洋是1975年科学出版社出版的图书作者是雷维尔1
货币Money是商品交换的产物是在商品交换过程中从商品世界分离出来的固定地充当一般等价物的商品是通货3的一种俗称金钱通货CurrencyCCY是度量价格的工具购买货物的媒介保存财富的手段是财产的所有者与市场关于交换权的契约本质上是所有者之间的约定包含流通中的货币银行券等	市场market是各方参与交换的多种系统机构程序法律强化和基础设施之一尽管各方可以通过易货交换货物和服务但大多数市场依赖卖方提供货物或服务包括劳力来换取买方的钱可以说市场是商品和服务价格建立的过程市场促进贸易并促成社会中的资源分配市场允许任何可交易项目进行评估和定价市场或多或少自发地出现或者可以通过人际互动刻意地构建以便交换服务和商品的权利比如所有权市场通常取代礼品经济通常通过规则和习俗如摊位费竞争性定价出售货物来源当地农产品或股票登记和军事或警察威胁如果这些规则被破坏市场可能因所销售的产品货物服务或因素劳动力和资本产品差异化交换所在地购买者针对性持续时间销售流程政府监管税收补贴最低工资价格上限交易合法性流动性投机强度规模集中度交易不对称性相对价格波动性和地域延伸市场的地理边界可能差异很大例如单一建筑中的食品市场当地城市的房地产市场整个国家的消费市场或同一规则适用的国际贸易集团的经济始终市场也可以是全球性的例如全球钻石贸易国家经济也可以分为发达市场或发展中市场市场泛指商品交换的领域如国际市场国内市场农村市场等
钱是商品交换的产物在原始社会末期最早出现的货币是实物货币一般来说游牧民族以牲畜兽皮类来实现货币职能而农业民族以五谷布帛农具陶器海贝珠玉等充当最早的实物货币	存款指存款人在保留所有权的条件下把资金或货币暂时转让或存储于银行或其他金融机构或者是说把使用权暂时转让给银行或其他金融机构的资金或货币是最基本也最重要的金融行为或活动也是银行最重要的信贷资金来源
海岸是高珊演唱的歌曲收录于2019年10月22日专辑海岸中1	岸是由杨光煜演唱的歌曲该曲收录于杨光煜发行的同名专辑岸中1
食物是2019年浙江教育出版社出版的图书	水果是2019年陕西人民教育出版社出版的图书1
喝武林群侠传侠客风云传中人物	吃是河洛工作室作品武林群侠传侠客风云传中的人物
钱是1983年上映的美国剧情电影由罗伯特布列松执导克里斯琴佩蒂及马克厄恩斯特等主演钱讲述了一张500元法郎的假钞在很多人之间转手最后落到了一个叫伊文的年轻人手中在他使用这张钱时被发现并被捕入狱从而改变了他的命运	财富是1999年上映的美国影片由罗伯特奥特曼执导格伦克洛斯丽芙泰勒主演影片讲述一个作风传统的家族的长者Cookie自杀后家人担心此事将影响家族的声誉于是将现场伪造成入室行窃杀人所引发的一连串故事
计算机computer俗称电脑是现代一种用于高速计算的电子计算机器可以进行数值计算又可以进行逻辑计算还具有存储记忆功能是能够按照程序运行自动高速处理海量数据的现代化智能电子设备由硬件系统和软件系统所组成没有安装任何软件的计算机称为裸机可分为超级计算机工业控制计算机网络计算机个人计算机嵌入式计算机五类较先进的计算机有生物计算机光子计算机量子计算机等计算机发明者约翰冯诺依曼计算机是20世纪最先进的科学技术发明之一对人类的生产活动和社会活动产生了极其重要的影响并以强大的生命力飞速发展它的应用领域从最初的军事科研应用扩展到社会的各个领域已形成了规模巨大的计算机产业带动了全球范围的技术进步由此引发了深刻的社会变革计算机已遍及一般学校企事业单位进入寻常百姓家成为信息社会中必不可少的工具计算机的应用在中国越来越普遍改革开放以后中国计算机用户的数量不断攀升应用水平不断提高特别是互联网通信多媒体等领域的应用取得了不错的成绩1996年至2009年计算机用户数量从原来的630万增长至6710万台联网计算机台数由原来的29万台上升至5940万台互联网用户已经达到316亿无线互联网有67亿移动用户其中手机上网用户达117亿为全球第一位	互联网internet又称国际网络指的是网络与网络之间所串连成的庞大网络这些网络以一组通用的协议相连形成逻辑上的单一巨大国际网络互联网始于1969年美国的阿帕网通常internet泛指互联网而Internet则特指因特网这种将计算机网络互相联接在一起的方法可称作网络互联在这基础上发展出覆盖全世界的全球性互联网络称互联网即是互相连接一起的网络结构互联网并不等同万维网万维网只是一建基于超文本相互链接而成的全球性系统且是互联网所能提供的服务其中之一截至2022年6月末中国3家基础电信企业的固定互联网宽带接入用户总数达563亿户比上年末净增2705万户中国固网宽带的平均下载速率和移动网络平均下载速率都居世界前列9
男人拼音nnrn指性成熟的雄性人类或指丈夫zhngfu男性同女人相对从生理学上讲具有XY染色体的人就是男人在生理心理上具有区别于女人的特征如具有男性生殖系统从动物学上讲男人即为雄性的人类	女人同男人相对从生理学上讲具有xx染色体的人就是女人在生理上具有区别于男人的特征如具有女性生殖系统从动物学上讲女人即为雌性的人类
国王是由英国美国联合制片的105分钟剧情影片该片由詹姆斯马什执导盖尔加西亚贝纳尔贝尔詹姆斯保罗达诺威廉赫特劳拉哈灵等主演于2005年5月15日在法国戛纳电影节上映该片讲述了一个海军退役后找到亲生父亲被拒绝相认后对父亲一家复仇的悲剧故事1	女王是由斯蒂芬弗雷斯执导海伦米伦迈克尔辛詹姆斯克伦威尔海伦麦克洛瑞阿历克斯杰宁斯主演的传记电影于2007年8月31日在中国大陆上映该片是一个以真实事件为背景而虚构的故事讲述了英国王妃黛安娜身亡后英国王室与大众之间出现的矛盾以及布莱尔首相与女王之间的交流沟通1
伏特加酒vodka俄罗斯的传统酒精饮料伏特加酒以谷物或马铃薯为原料经过蒸馏制成高达95度的酒精再用蒸馏水淡化至40度到60度并经过活性炭过滤使酒质更加晶莹澄澈无色且清淡爽口使人感到不甜不苦不涩只有烈焰般的刺激形成伏特加酒独具一格的特色伏特加酒在各种调制鸡尾酒的基酒之中是一种最具有灵活性适应性和变通性的酒12018年1月3日全世界最昂贵的一瓶鲁索巴尔特RussoBaltique伏特加酒价值130万美元在丹麦酒吧被盗2	白兰地酒是由筱原哲雄执导的电影由筱原哲雄担任编剧由县森鱼朝加真由美主演1
婴儿是一首白雪演唱的歌曲该首歌曲发行于2007年07月16日出自于其专辑裸胆1	歌曲母亲由HAYA乐团发行的纯音乐发行于2007年12月14日收录于专辑狼图腾中1
音乐会或演奏会是指在观众前的现场表演通常是音乐的表演音乐可以是由单独的音乐人所表演称作recital或是音乐团体的集体演出像是管弦乐团合唱团等音乐会的通俗称号也叫show与gig音乐会所举办的地点有着许多的可能例如公共演艺厅夜总会音乐屋体育馆谷仓音乐厅和多功能的表演场所等等音乐家通常是在舞台上表演在唱片尚未流行前音乐会是听众唯一的机会听到音乐家的演奏	演奏家指拥有精湛的音乐演奏技术的音乐家
迭戈阿曼多马拉多纳DiegoArmandoMaradona1960年10月30日2020年11月25日出生于阿根廷布宜诺斯艾利斯阿根廷职业足球运动员教练员司职中前场11975年10月马拉多纳完成了在阿根廷甲级联赛的处子秀21978年成为阿根廷甲级联赛联赛历史上最年轻的最佳射手31979年9月马拉多纳率领阿根廷队获得世界青年足球锦标赛冠军41982年7月马拉多纳转会至西甲球队巴塞罗那51984年7月马拉多纳以创纪录的750万美元转会费加盟意大利那不勒斯队61986年6月马拉多纳在世界杯上演上帝之手和世纪进球率领阿根廷队获得世界杯冠军6901990年7月马拉多纳率领的阿根廷队在世界杯决赛中不敌德国队获得亚军71997年10月29日马拉多纳宣布退役12008年11月5日马拉多纳出任阿根廷国家队主教练82010年7月28日阿根廷足协官方宣布马拉多纳不再担任阿根廷国家队主教练92017年12月马拉多纳担任2018年世界杯抽签仪式抽签嘉宾10马拉多纳被认为是二十世纪最伟大的足球运动员他不仅拥有南美球员精准的脚法和极其娴熟的带球技术大局观也非常出色在任何一支球队他都是绝对灵魂可以将球队整体盘活112020年11月25日马拉多纳在家中突发心梗去世享年60岁1214阿根廷总统府发布公告称全国进入为期三天的哀悼期15	足球Football英Soccer美是一项以脚为主控制和支配球两支球队按照一定规则在同一块长方形球场上互相进行进攻防守对抗的体育运动项目因足球运动对抗性强战术多变参与人数多等特点故被称为世界第一运动1现代足球的前身起源于中国古代山东淄州今淄博市的球类游戏蹴鞠后经阿拉伯人由中国传至欧洲逐渐演变发展为现代足球现代足球始于英国21848年足球运动历史上第一部文字形式的规则剑桥规则诞生1863年10月26日英格兰成立了世界上第一所足球协会并统一了足球运动的竞赛规则31872年英格兰与苏格兰之间举行了足球史上第一次协会间的正式比赛1900年在第二届夏季奥林匹克运动会中足球被列入正式项目4足球在全球被广泛译为Football只有在美国等极少数国家被译为Soccer而Football在美国加拿大被指为美式橄榄球56足球的最高组织机构为国际足球联合会成立于1904年总部设于瑞士苏黎世中国最高组织机构是中国足球协会1955年1月3日成立于北京78
比赛汉语词汇拼音bsi意思指在体育生产等活动中比较本领技术的高低	团队Team是由基层和管理层人员组成的一个共同体它合理利用每一个成员的知识和技能协同工作解决问题达到共同的目标团队的构成要素总结为5P分别为目标人定位权限计划团队和群体有着根本性的一些区别群体可以向团队过渡一般根据团队存在的目的和拥有自主权的大小将团队分为五种类型问题解决型团队自我管理型团队多功能型团队共同目标型团队正面默契型团队
摇滚乐英文全称为RockandRoll兴起于20世纪50年代中期主要受到节奏蓝调乡村音乐和叮砰巷音乐的影响发展而来早期摇滚乐很多都是黑人节奏蓝调的翻唱版因而节奏布鲁斯是其主要根基摇滚乐分支众多形态复杂主要风格有民谣摇滚艺术摇滚迷幻摇滚乡村摇滚重金属朋克另类摇滚等代表人物有埃尔维斯普雷斯利猫王鲍勃迪伦平克弗洛伊德乐队滚石乐队地下丝绒乐队黑色安息日乐队皇后乐队等是20世纪美国大众音乐走向成熟的重要标志而中国摇滚乐兴起于20世纪80年代初1986年崔健以一首一无所有喊出了中国摇滚第一声90年代中期为中国摇滚的高峰期	爵士乐Jazz音乐类型于19世纪末20世纪初源于美国诞生于南部港口城市新奥尔良音乐根基来自布鲁斯Blues和拉格泰姆Ragtime爵士乐讲究即兴以具有摇摆特点的Shuffle节奏为基础是非洲黑人文化和欧洲白人文化的结合20世纪前十几年爵士乐主要集中在新奥尔良发展1917年后转向芝加哥30年代又转移至纽约爵士乐风靡全球爵士乐的主要风格有新奥尔良爵士乐摇摆乐比博普冷爵士自由爵士乐拉丁爵士融合爵士等
歌剧Opera是用声乐和器乐表现剧情的戏剧作品是音乐与诗歌戏剧表演舞蹈舞台美术服装等结合为一体的综合性艺术体裁12歌剧的结构通常包括序曲间奏曲合唱重唱独唱等歌剧中主角的独唱又分为咏叹调宣叙调还有小咏叹调咏叙调卡伐蒂娜浪漫曲与小夜曲等1	表演著作权法术语指演奏乐曲上演剧本朗诵诗词等直接或者借助技术设备以声音表情动作公开再现的作品
面包也写作麺包一种用五谷一般是麦类磨粉制作并加热而制成的食品以小麦粉为主要原料以酵母鸡蛋油脂糖盐等为辅料加水调制成面团经过分割成形醒发焙烤冷却等过程加工而成的焙烤食品	黄油Butter是用牛奶加工出来的一种固态油脂是把新鲜牛奶加以搅拌之后上层的浓稠状物体滤去部分水分之后的产物主要用作调味品营养丰富但含脂量很高所以不要过分食用公元前5世纪匈奴人就已经因为以牧业为主奶制品各种制作技术成熟并传播国内外外国人称为黄油就是中国人称为奶油的奶中炼制食用油品匈奴人是世界上最早加工食用黄油的民族
国家是政治地理学名词从广义的角度国家是指拥有共同的语言文化种族领土政府或者历史的社会群体从狭义的角度国家是一定范围内的人群所形成的共同体形式学术界对于国家的组成要素有两种说法常见的观点有三要素说和四要素说有的学者认为国家由个3要素组成例如美国法学家汉斯凯尔森在1946年出版的法与国家的一般理论中评论说传统学说划分国家的三个要素国家的领土人民和权力6在此之后他在1952年出版的国际法原理中说传统学说把国家的个3要素概括为领土人民和由一个独立的和有实效的政府行使的权力7而美国法学家杰克逊认为国际法中普遍接受的国家的定义的必要要素是居民领土和有效的政府10有的学者认为国家由4个要素组成例如美国法学家克雷文认为国家资格的必要要素是定居的居民确定的领土有效的政府和独立11中国国际法学家王铁崖先生认为国际法中的国家应具备定居的人民确定的领土政府主权四个要素89在社会科学和人文地理范畴国家是指被人民文化语言地理区别出来的领土被政治自治权区别出来的一块领地一个领地或者邦国的人民跟特定的人有关联的地区一般国家行政管理当局是国家的象征它是一种拥有治理一个社会的权力的国家机构在一定的领土内拥有外部和内部的主权	公民为我国宪法所确定的基本权利的一般性的主体根据我国现行宪法第33条第1款的规定凡是具有中华人民共和国国籍的人都是中华人民共和国公民也就是说具有国籍是确定我国公民资格的唯一要件
伏特加酒vodka俄罗斯的传统酒精饮料伏特加酒以谷物或马铃薯为原料经过蒸馏制成高达95度的酒精再用蒸馏水淡化至40度到60度并经过活性炭过滤使酒质更加晶莹澄澈无色且清淡爽口使人感到不甜不苦不涩只有烈焰般的刺激形成伏特加酒独具一格的特色伏特加酒在各种调制鸡尾酒的基酒之中是一种最具有灵活性适应性和变通性的酒12018年1月3日全世界最昂贵的一瓶鲁索巴尔特RussoBaltique伏特加酒价值130万美元在丹麦酒吧被盗2	金酒又名叫杜松子酒Geneva或琴酒最先由荷兰生产在英国大量生产后闻名于世是世界第一大类的烈酒金酒按口味风格又可分为辣味金酒老汤姆金酒和果味金酒1
股票stock是股份公司所有权的一部分也是发行的所有权凭证是股份公司为筹集资金而发行给各个股东作为持股凭证并借以取得股息和红利的一种有价证券股票是资本市场的长期信用工具可以转让买卖股东凭借它可以分享公司的利润但也要承担公司运作错误所带来的风险每股股票都代表股东对企业拥有一个基本单位的所有权每家上市公司都会发行股票同一类别的每一份股票所代表的公司所有权是相等的每个股东所拥有的公司所有权份额的大小取决于其持有的股票数量占公司总股本的比重股票是股份公司资本的构成部分可以转让买卖是资本市场的主要长期信用工具但不能要求公司返还其出资1	市场market是各方参与交换的多种系统机构程序法律强化和基础设施之一尽管各方可以通过易货交换货物和服务但大多数市场依赖卖方提供货物或服务包括劳力来换取买方的钱可以说市场是商品和服务价格建立的过程市场促进贸易并促成社会中的资源分配市场允许任何可交易项目进行评估和定价市场或多或少自发地出现或者可以通过人际互动刻意地构建以便交换服务和商品的权利比如所有权市场通常取代礼品经济通常通过规则和习俗如摊位费竞争性定价出售货物来源当地农产品或股票登记和军事或警察威胁如果这些规则被破坏市场可能因所销售的产品货物服务或因素劳动力和资本产品差异化交换所在地购买者针对性持续时间销售流程政府监管税收补贴最低工资价格上限交易合法性流动性投机强度规模集中度交易不对称性相对价格波动性和地域延伸市场的地理边界可能差异很大例如单一建筑中的食品市场当地城市的房地产市场整个国家的消费市场或同一规则适用的国际贸易集团的经济始终市场也可以是全球性的例如全球钻石贸易国家经济也可以分为发达市场或发展中市场市场泛指商品交换的领域如国际市场国内市场农村市场等
网络是由若干节点和连接这些节点的链路构成表示诸多对象及其相互联系在1999年之前人们一般认为网络的结构都是随机的但随着Barabasi和Watts在1999年分别发现了网络的无标度和小世界特性并分别在世界著名的科学和自然杂志上发表了他们的发现之后人们才认识到网络的复杂性1网络会借助文字阅读图片查看影音播放下载传输游戏聊天等软件工具从文字图片声音视频等方面给人们带来极其丰富的生活和美好的享受	硬件英文名Hardware是计算机硬件的简称中国大陆及香港用语台湾叫作硬体是指计算机系统中由电子机械和光电元件等组成的各种物理装置的总称这些物理装置按系统结构的要求构成一个有机整体为计算机软件运行提供物质基础简而言之硬件的功能是输入并存储程序和数据以及执行程序把数据加工成可以利用的形式从外观上来看微机由主机箱和外部设备组成主机箱内主要包括CPU内存主板硬盘驱动器光盘驱动器各种扩展卡连接线电源等外部设备包括鼠标键盘等
管理者是指在组织中直接参与和帮助他人工作的人管理者通过其地位和知识对组织负有贡献的责任因而能够实质性的影响该组织经营及达成成果的能力者现代观点强调管理者必须对组织负责而不仅仅是监督指导与管理者相对应的是非管理者	办公室读音bngngsh英文名Office处理一种特定事务的地方或提供服务的地方是提供工作办公的场所不同类型的企业办公场所有所不同由办公设备办公人员及其它辅助设备组成在办公室适合放些对人和工作氛围有帮助的东西如花画等办公室还可以指一种机构如区委办公室区政府办公室党校办公室等它是一个单位对外的窗口对内协助领导工作的机关
心理学是2019年中国人民大学出版社出版的图书1	认知是2019年中国人口出版社出版的图书1
钱汉语常用字一级字1最早见于战国文字2本义为农田农具名指类似铁锹一类的农具读为jin在现代汉语中钱专指货币当钱用为指称货币费用量词姓氏时均读为qin基本信息栏参考资料3	经营含有筹划谋划计划规划组织治理管理等含义经营和管理相比经营侧重指动态性谋划发展的内涵而管理侧重指使其正常合理地运转经营和管理合称经营管理在日本和韩国管理学一般称为经营学也统称经营管理学或企业经营管理学1现代汉语词典中的解释一筹划并管理企业等经营商业经营畜牧业苦心经营二泛指计划和组织这个展览会是煞费经营的1运营营利性事业从事营利性的工作2苦心筹划3为一定目的而设法使机构或组织运转企业的经营企业的经营是根据企业的资源状况和所处的市场竞争环境对企业长期发展进行战略性规划和部署制定企业的远景目标和方针的战略层次活动它解决的是企业的发展方向发展战略问题具有全局性和长远性是企业或经营者有目的的经济活动是经营者在国家的方针政策指导下根据国家计划任务市场需求状况及企业自身的需要从本身所处的内外环境条件出发对企业的经济活动进行的筹划设计与安排等活动
自然从最广泛的意义上说是自然的物理的物质的世界或宇宙自然可以指物理世界的现象也可以指一般的生命对自然的研究即使不是科学也是很大的一部分尽管人类是自然的一部分但人类活动通常被理解为与其他自然现象不同的类别这个词的各种用法中自然通常指的是地质学和野生动物自然可以指有生命的植物和动物的一般领域在某些情况下可以指与无生命物体相关的过程特定类型的事物存在的方式和它们自己的变化例如地球的天气和地质它通常被用来表示自然环境或荒野野生动物岩石森林以及一般来说那些没有被人类干预实质性改变的东西或者尽管人类干预仍然存在的东西例如人造物体和人类互动通常不被视为自然的一部分除非被限定为例如人性或整个自然这个可以找到的关于自然事物的更传统的概念意味着自然和人工之间的区别人工存在被理解为由人类意识或人类思想产生的东西根据特定的上下文术语自然也可能与非自然或超自然区分开来3	人rn英语为Mankind可以从生物精神与文化等各个层面来定义或是这些层面定义的结合生物学上人被分类为人科人属人种2号染色体和猩猩甲条染色体着丝粒融合平衡易位缔合模式接近度超过16N并臂间多次倒位其余染色体都有很强的同源性是一种高级动物精神层面上人被描述为能够使用各种灵魂的概念在宗教中这些灵魂被认为与神圣的力量或存在有关文化人类学上人被定义为能够使用语言具有复杂的社会组织与科技发展的生物尤其是能够建立团体与机构来达到互相支持与协助目的中国古代对人的定义是有历史典籍能把历史典籍当作镜子以自省的动物
拳击是吉林出版集团有限责任公司出版的图书作者是岳言等主编1	回合是由作曲王铮作词金玟岐演唱的游戏梦幻西游成长版主题曲1
心理学是1993年科学出版社出版的图书	科学是2008年科学普及出版社出版的图书1
公告是指政府团体对重大事件当众正式公布或者公开宣告宣布国务院2012年4月16日发布2012年7月1日起施行的党政机关公文处理工作条例对公告的使用表述为适用于向国内外宣布重要事项或者法定事项其中包含两方面的内容一是向国内外宣布重要事项公布依据政策法令采取的重大行动等二是向国内外宣布法定事项公布依据法律规定告知国内外的有关重要规定和重大行动等	新闻1也叫消息资讯是通过报纸电台广播电视台等媒体途径所传播信息的2一种称谓是记录社会传播信息反映时代的一种文体新闻概念有广义与狭义之分就其广义而言除了发表于报刊广播互联网电视上的评论与专文外的常用文本都属于新闻之列包括消息通讯特写速写有的将速写纳入特写之列等等3狭义的新闻则专指消息消息是用概括的叙述方式比较简明扼要的文字迅速及时地报道国内外新近发生的有价值的事实让别人了解每则新闻一般包括标题电头导语主体背景和结语六部分前四者是主要部分后二者是辅助部分标题导语主体必不可少写法上主要是叙述有时兼有议论描写评论等新闻是包含海量资讯的新闻服务平台真实反映每时每刻的重要事件可以通过查看新闻事件热点话题人物动态产品资讯等快速了解它们的最新进展4
比赛是电视剧功夫足球的主题曲由张卫健演唱发行于2004年	回合是由作曲王铮作词金玟岐演唱的游戏梦幻西游成长版主题曲1
红利是指上市公司在进行利润分配时分配给股东的利润一般是每10股派发XX元股东在获得时还要扣掉上交税额普通股股东所得到的超过股息部分的利润称为红利普通股股东所得红利没有固定数额企业分派给股东多少红利则取决于企业年度经营状况的好坏和企业今后经营发展战略决策的总体安排在美国大多数公司发放现金红利数额约占公司税后净利的4060公司红利发放时间大都是按季度进行每一季度分发一次一定数量或一定比例的红利如果还有多余公司还可在某一时候追加发放	报酬形容得到他人帮助之后进行报答有时又指薪水工作后所得到的物品或钱财
白天男汉族1957年5月出生山西平定人1974年2月参加工作1986年6月加入中国共产党大学学历现任吕梁市发改委总经济师	黎明男汉族湖北郧县人1972年5月出生硕士研究生学历1997年7月参加工作1997年1月加入中国共产党现任猇亭区人民政府副区长党组成员东风汽车公司经营管理部经营协同处业务主任
物理学physics是研究物质最一般的运动规律和物质基本结构的学科作为自然科学的带头学科物理学研究大至宇宙小至基本粒子等一切物质最基本的运动形式和规律因此成为其他各自然科学学科的研究基础物理学起始于伽利略和牛顿的年代它已经成为一门有众多分支的基础科学物理学是一门实验科学也是一门崇尚理性重视逻辑推理的科学物理学充分用数学作为自己的工作语言它是当今最精密的一门自然科学学科1	质子proton是一种带161019库仑C正电荷的亚原子粒子直径约16171015m质量是938百万电子伏特cMeVc即1672621637831027千克大约是电子质量的18365倍电子的质量为910938215451031千克质子比中子稍轻中子的质量为1674927211841027千克质子属于重子类由两个上夸克和一个下夸克通过胶子在强相互作用下构成原子核中质子数目决定其元素的种类和它属于何种化学元素1
道德是社会意识形态之一是人们共同生活及其行为的准则和规范1道德通过社会的或一定阶级的舆论对社会生活起约束作用22019年10月中共中央国务院印发了新时代公民道德建设实施纲要并发出通知要求各地区各部门结合实际认真贯彻落实3	婚姻泛指婚龄男女以夫妻名义在经济生活精神物质等方面的自愿长期结合根据双方身体条件工作能力结婚观念历史文化而产生的夫妻关系应取得医学伦理民法等层面的认可以夫妻名义共同生产生活并组成家庭的一种社会现象男女自愿结合在一起互相接受互相依靠婚姻应与社会人口变化历史文化相适应中国是一个历史悠久多民族国家婚姻制度也经过多次变革现在普遍认同一女一男一妻一夫形式古时又称昏姻或昏因一般而言婚姻一词的起源有三种说法汉朝的郑玄说婚姻指的是嫁娶之礼在我国古代的婚礼中男方通常在黄昏时到女家迎亲而女方随着男方出门这种男以昏时迎女女因男而来的习俗就是昏因一词的起源换句话说婚姻一般是指男娶女嫁过程1
钱是罗伯特布列松执导的犯罪片克里斯蒂安佩蒂和VincentRisterucci出演该片讲述了小伙子伊万把自己的命运引向不可知的远方的故事	银行是由查理卓别林导演艾德娜珀薇安丝主演的一部影片
铝Aluminium是一种金属元素元素符号为Al原子序数为13其单质是一种银白色轻金属有延展性商品常制成棒状片状箔状粉状带状和丝状在潮湿空气中能形成一层防止金属腐蚀的氧化膜铝粉在空气中加热能猛烈燃烧并发出眩目的白色火焰易溶于稀硫酸硝酸盐酸氢氧化钠和氢氧化钾溶液难溶于水相对密度270熔点660沸点2327铝元素在地壳中的含量仅次于氧和硅居第三位是地壳中含量最丰富的金属元素航空建筑汽车三大重要工业的发展要求材料特性具有铝及其合金的独特性质这就大大有利于这种新金属铝的生产和应用应用极为广泛2017年10月27日世界卫生组织国际癌症研究机构公布的致癌物清单初步整理参考铝生产过程在一类致癌物清单中	金属一般指具备特有光泽即对可见光强烈反射而不透明具有延展性及导热导电性的一类物质狭义的金属概念为由金属元素组成的单质4纯金属在常温下一般都是固体汞除外大多数为电和热的优良导体密度较大熔点较高1地球上的金属资源广泛地存在于地壳和海洋中除少数很不活泼的金属如金银等有单质形式存在外其余都以化合物的形式存在1金属在自然界中广泛存在在生活中应用极为普遍在现代工业中是非常重要和应用最多的一类物质
投资者是指投入现金购买某种资产以期望获取利益或利润的自然人和法人广义的投资者包括公司股东债权人和利益相关者狭义的投资者指的就是股东	收入会计学术语会计要素之一是指企业在日常活动中形成的会导致所有者权益增加的与所有者投入资本无关的经济利益的总流入收入按企业从事日常活动的性质不同分为销售商品收入提供劳务收入和让渡资产使用权收入收入按企业经营业务的主次不同分为主营业务收入和其他业务收入主营业务收入是指企业为完成其经营目标所从事的经常性活动所实现的收入其他业务收入是指企业为完成其经营目标所从事的与经常性活动相关的活动实现的收入企业会计准则第14号一一收入已于2017年7月由财政部修订发布自2018年1月1日起在境内外同时上市的企业以及在境外上市并采用国际财务报告准则或企业会计准则编制财务报表的企业施行自2020年1月1日起在其他境内上市企业施行自2021年1月1日起在执行企业会计准则的非上市企业施行1
展览exhibition读音zhnln著作权法术语指公开陈列美术作品摄影作品的原件或者复制件展览会既是信息通讯和娱乐的综合也是唯一的在面对面沟通中充分挖掘五官感觉的营销媒介20世纪尽管出现高速的电子通讯方式展览会作为临时的市场仍然是最专业有效的销售工具	纪念品是指可以承载纪念意义的物品纪念品通常是以实物而存在的能长时间保存在人际间的交往中可以起到增进感情加深印象的作用
空间是与时间相对的一种物质客观存在形式但两者密不可分按照宇宙大爆炸理论宇宙从奇点爆炸之后宇宙的状态由初始的一分裂开来从而有了不同的存在形式运动状态等差异物与物的位置差异度量称之为空间位置的变化则由时间度量空间由长度宽度高度大小表现出来通常指四方方向上下空间有宇宙空间网络空间思想空间数字空间物理空间等等都属空间的范畴地理学与天文学中指地球表面的一部分有绝对空间与相对空间之分空间由不同的线组成线组成不同形状线内便是空间空间是一个相对概念构成了事物的抽象概念事物的抽象概念是参照于空间存在的1	世界world广义上来讲就是指全部所有一切一般来讲世界指的是人类赖以生存的地球世界还代称的有天地天下此岸世间万物世上等世界也可解释由可感知的不可感知的客观存在的总和以及用于描述客观存在及其相互关系的概念总和客观存在是不以人或其他物意志转移而存在的世界由概念世界和物质世界组成概念世界包含所有生命对客观世界的认知以及为记录认知而存在的事物的总和
夏季是一年四季中第二个季节从立夏起至立秋结束气温高是夏季最显著的气候特征但因地域干湿环境的不同会产生炎热干燥或者湿热多雨的不同气候中国幅员辽阔各地区夏季的气候并非一样总体来说中国东南部季风区夏季高温多雨西南高海拔地区夏季凉爽降水少西北地区夏季炎热干燥春生夏长秋收冬藏夏季是许多农作物旺盛生长的最好季节充足的光照和适宜的温度以及充沛的雨水给植物提供了所需的条件季风气候是中国气候的主要特点夏季受来自海洋的暖湿气流的影响表现为高温潮湿多雨雨热同期有利于农作物成长在夏季农作物进入了茁壮成长阶段	干旱是指长期无雨或少雨使土壤水分不足作物水分平衡遭到破坏而减产的气象灾害12干旱亦指淡水总量少不足以满足人的生存和经济发展的气候现象一般是长期的现象干旱都是人类面临的主要自然灾害即使在科技发达它造成的灾难性后果仍然比比皆是值得注意的是随着人类的经济发展和人口膨胀水资源短缺现象日趋严重这也直接导致了干旱地区的扩大与干旱化程度的加重干旱化趋势已成为全球关注的问题2021年中国全年因干旱灾害造成直接经济损失201亿元11
钱姓中华姓氏之一在宋版百家姓中排名为第2位1钱姓可以追溯至黄帝七世孙彭祖这位史传寿高880岁的寿星真名叫篯铿后被尧赏识受封于大彭成为彭姓的祖先而彭祖之子篯孚在西周都城任钱府掌管钱财的官署上士官名篯孚就以钱为姓所以彭姓与钱姓本为一家民间至今也有彭钱不分家的说法由于西周建都于镐京今陕西西安篯孚必在京为官所以钱姓也是发源于陕西一带2先秦时钱姓表现不明朗秦汉时期钱姓在江苏徐州一带静静地发展起来三国时钱姓已经遍布了江苏浙江和安徽晋朝时江西成为钱姓的另一重要的基地唐朝之前钱姓已经分布到中原和长江南北钱姓发展的鼎盛时期是在唐宋之际钱镠在临安称帝即在今浙江杭州建立了吴越国传五主割据江苏南部和浙江一带达86年钱镠的子孙分封到各地子孙很快在江浙地区繁衍不久钱姓进入了闽粤地区清初涉足台湾342013年钱姓人口约有249万排在全国第93位钱姓人口主要分布在江苏浙江上海安徽湖北云南等省市5	美元UnitedStatesdollar货币缩写USDISO4217货币代码USD符号USA是美利坚合众国萨尔瓦多共和国巴拿马共和国厄瓜多尔共和国东帝汶民主共和国马绍尔群岛共和国密克罗尼西亚联邦基里巴斯共和国和帕劳共和国的法定货币流通的美元纸币是自1929年以来发行的各版钞票1792年美国铸币法案通过后出现当前美元的发行是由美国联邦储备系统控制自1913年起美国建立联邦储备制度发行联邦储备券现行流通的钞票中99以上为联邦储备券美元的发行主管部门是国会具体发行业务由联邦储备银行负责办理在二战以后欧洲大陆国家与美国达成协议同意使用美元进行国际支付此后美元作为储备货币在美国以外的国家广泛使用并最终成为国际货币1截止2021年12月16日晚10点里拉对美元汇率已经超过156创下新低2021年以来里拉对美元贬值幅度超过503
对于判例必须分别来看在民法法系判例是非正式的法律渊源除了个别情况外理论上不承认判例具有约束力在普通法法系判例是正式的法律渊源即判例法公共政策是有关必须达到集体目的或目标的一种政治决定这种决定一般来说旨在改善经济政治或者社会的境况或旨在促进整个社会的某种集体目标的实现事物性质实际上是一种知识或人们对事物内在规律的认识1	前情汉语词语拼音是qinqng释义1先前的情况2先前的感情1
道德是一个汉语词语拼音是dod一指社会意识形态之一二指合乎道德的三指老子道德经的省称四指僧道修行的功夫法术1	重要性又称意义或重要意义人们在宣传中常常分析作品人物或事件的意义重要性这是指它们的时代价值和社会价值英文意蕴meaning翻译成现代汉语有意义意思的含义但在解释学中是指作品本身具有的含意不涉及作品在理解中延伸出来的意义即significance显然意义重要性和意蕴是两个不同的概念作品事件人物的意蕴在其内部先于理解而存在作品事件和人物的重要性则依据时代或理解者的切身利益而变化1
公司是上海人民出版社出版的图书作者是加巴肯BakanJ著1	股票是2004年科学出版社出版的图书作者是日杉村富生1
旅行是汉语词汇拼音是lxng意思指远行去外地办事或游览去外地行走不同于旅游旅行和旅游的区别就在于旅行是在观察身边的景色和事物行万里路读万卷书相对于是指个人是行走旅游是指游玩通常是团体出行在时间上是很短暂的旅游就是旅行游览活动它是一种复杂的社会现象旅行要涉及到社会的政治经济文化历史地理法律等各个社会领域旅游也是一种娱乐活动任何去外地游玩都可以算世界旅游组织指旅行的定义是某人出外最少离家55英里885千米	活动是由共同目的联合起来并完成一定社会职能的动作的总和活动由目的动机动作和共同性构成具有完整的结构系统苏联心理学家从20年代起就对活动进行了一系列研究其中列昂节夫的活动理论对苏联心理学的发展影响很大成为现代苏联心理学的重要理论基石
联邦调查局是梅尔文勒罗伊执导詹姆斯斯图尔特维拉迈尔斯主演的美国电影该片于1959年出品12	调查是一部由托比亚斯林道赫姆执导的电视剧该剧由索伦莫灵皮鲁埃斯贝克担任主演于2020年9月28日首播1
奖章拼音jingzhng是授予有功人员比赛成绩优异等的徽章	英勇yngyngheroicvaliantbravegallant汉语词汇拼音yngyng释义勇敢出众无所畏惧勇敢果断
龙虾是中国大陆上海美术电影制片厂制作的一部木偶剧动画片该动画片根据芦丹同名话剧改编而成于1958年上映	食物是1993年上映的捷克斯洛伐克电影由杨史云梅耶导演BedrichGlaserLudvkSvb主演
电话是由李聪贤执导朴智恩担任编剧全钟瑞朴信惠领衔主演的惊悚电影1影片讲述了金书妍和吴英淑这两个生活在不同时间线上的女子因为一通电话而发生关联的惊悚故事2该片于2020年11月27日在Netflix线上上映3	设备是JeremyBerg执导的恐怖片AngelaDiMarco和大卫霍根出演该片讲述了两姐妹发现一个奇怪的外星物体的故事
阵雨Showers降自积雨云中就是雨时短促开始和终止都很突然降水强度变化很大的雨有时伴有闪电和雷鸣多发生在夏季阵雨有不连续性特点范围一般不大带有雨幡且往往伴有大风出现1	洪水是由暴雨急骤融冰化雪风暴潮等自然因素引起的江河湖海水量迅速增加或水位迅猛上涨的水流现象当流域内发生暴雨或融雪产生径流时都依其远近先后汇集于河道的出口断面处当近处的径流到达时河水流量开始增加水位相应上涨这时称洪水起涨及至大部分高强度的地表径流汇集到出口断面时河水流量增至最大值称为洪峰流量其相应的最高水位称为洪峰水位到暴雨停止以后的一定时间流域地表径流及存蓄在地面表土及河网中的水量均已流出出口断面时河水流量及水位回落至原来状态洪水从起涨至峰顶到回落的整个过程连接的曲线称为洪水过程线其流出的总水量称洪水总量
足球Football英Soccer美是一项以脚为主控制和支配球两支球队按照一定规则在同一块长方形球场上互相进行进攻防守对抗的体育运动项目因足球运动对抗性强战术多变参与人数多等特点故被称为世界第一运动1现代足球的前身起源于中国古代山东淄州今淄博市的球类游戏蹴鞠后经阿拉伯人由中国传至欧洲逐渐演变发展为现代足球现代足球始于英国21848年足球运动历史上第一部文字形式的规则剑桥规则诞生1863年10月26日英格兰成立了世界上第一所足球协会并统一了足球运动的竞赛规则31872年英格兰与苏格兰之间举行了足球史上第一次协会间的正式比赛1900年在第二届夏季奥林匹克运动会中足球被列入正式项目4足球在全球被广泛译为Football只有在美国等极少数国家被译为Soccer而Football在美国加拿大被指为美式橄榄球56足球的最高组织机构为国际足球联合会成立于1904年总部设于瑞士苏黎世中国最高组织机构是中国足球协会1955年1月3日成立于北京78	篮球basketball是以手为中心的身体对抗性体育运动是奥运会核心比赛项目11891年12月21日由美国马萨诸塞州斯普林菲尔德基督教青年会训练学校体育教师詹姆士奈史密斯发明21896年篮球运动传入中国天津1904年圣路易斯奥运会上第1次进行了篮球表演赛1936年篮球在柏林奥运会中被列为正式比赛项目1中国也首次派出篮球队参加奥运会篮球项目1992年巴塞罗那奥运会开始职业选手可以参加奥运会篮球比赛12篮球的最高组织机构为国际篮球联合会于1932年成立总部设在瑞士日内瓦中国最高组织机构为中国篮球协会于1956年10月成立316
杯子是一种专门盛水的器皿其主要功能都是用来饮酒或饮茶一般容积不大或在古代喝茶的杯子被称为盖碗基本器型大多是直口或敞口口沿直径与杯高近乎相等有平底圈足或高足考古资料表明最早的杯始见于新石器时代无论是在仰韶文化龙山文化还是河姆渡文化遗址中都见有陶制杯的存在这一时期杯型最为奇特多样带耳的有单耳或双耳杯带足的多为锥形三足杯觚形杯高柄杯等等根据制作材料不同可以分为玻璃杯塑料杯陶瓷杯木杯等2	咖啡英语coffee是用经过烘焙磨粉的咖啡豆制作出来的饮料作为世界三大饮料之一其与可可茶同为流行于世界的主要饮品咖啡树是属茜草科多年生常绿灌木或小乔木日常饮用的咖啡是用咖啡豆配合各种不同的烹煮器具制作出来的而咖啡豆就是指咖啡树果实里面的果仁再用适当的方法烘焙而成一杯标准的咖啡品尝起来的味道不应该是苦涩的一名合格的咖啡师在制作咖啡时会严谨地进行每一步操作最后为客人呈上的咖啡在味觉上会呈现出不同程度的甜度酸度香醇度或是干净度
心理学是2015年浙江大学出版社出版的图书1	健康是2016年江苏大学出版社出版的图书1
tabulatearrangeincolumnsortables把制成表以表显示英文解释listlistfilesoftype以表格为容器装载着文字或图表的一种形式叫列表在互联网发展的同时还衍生了一种在以网上形式发表的列表简称网表	类别拼音是libi汉语词语意思是品类门类1
责任是一种职责和任务身处社会的个体成员必须遵守的规则和条文带有强制性它伴随着人类社会的出现而出现有社会就有责任责任感是衡量一个人精神素质的重要指标责任产生于社会关系中的相互承诺在社会的舞台上每种角色往往意味着一种责任当我们在承担一项责任的时候要付出一定的代价但也意味着获得回报的权利社会在发展责任内涵也在不断发展改革开放和现代化建设的伟大实践赋予责任日益丰富的时代内容负责任的大国负责任的政府负责任的公民中国以更加鲜明的形象呈现在世界面前	保险是一个汉语词语拼音是boxin英文是Insurance或insuraunce1本意是稳妥可靠保障后延伸成一种保障机制是用来规划人生财务的一种工具是市场经济条件下风险管理的基本手段是金融体系和社会保障体系的重要的支柱保险2是指投保人根据合同约定向保险人支付保险费保险人对于合同约定的可能发生的事故因其发生所造成的财产损失承担赔偿保险金责任或者被保险人死亡伤残疾病或者达到合同约定的年龄期限等条件时承担给付保险金责任的商业保险行为从经济角度看保险是分摊意外事故损失的一种财务安排从法律角度看保险是一种合同行为是一方同意补偿另一方损失的一种合同安排从社会角度看保险是社会经济保障制度的重要组成部分是社会生产和社会生活精巧的稳定器从风险管理角度看保险是风险管理的一种方法
日本人是2008年东方出版社出版的图书作者是李娜	美国人三部曲是上海译文出版社出版的图书作者是丹尼尔J布尔斯廷1
石油输出国组织简称欧佩克OPEC亚非拉石油生产国为协调成员国石油政策反对西方石油垄断资本的剥削和控制而建立的国际组织1960年9月成立它的宗旨是协调和统一成员国石油政策维持国际石油市场价格稳定确保石油生产国获得稳定收入最高权力机构为成员国大会由成员国代表团组成负责制定总政策执行机构为理事会日常工作由秘书处负责处理另设专门机构经济委员会以协助维持石油价格的稳定该组织自成立以来与西方石油垄断资本坚持斗争在提高石油价格和实行石油工业国有化方面取得重大进展1现有13个成员国是阿尔及利亚安哥拉刚果赤道几内亚加蓬伊朗伊拉克科威特利比亚尼日利亚沙特阿拉伯阿拉伯联合酋长国委内瑞拉2总部设在奥地利维也纳3卡塔尔于2019年1月退出石油输出国组织欧佩克42020年1月1日厄瓜多尔退出石油输出国组织52022年9月5日欧佩克和非欧佩克产油国欧佩克表示欧佩克决定再次将石油产量每天削减10万桶因此10月恢复到8月的协议条款11当地时间2022年10月5日石油输出国组织欧佩克与俄罗斯等非欧佩克产油国各方已就未来原油产量达成共识将减产200万桶日12	石油是指气态液态和固态的烃类混合物具有天然的产状石油又分为原油天然气天然气液及天然焦油等形式但习惯上仍将石油作为原油的定义用1石油是一种黏稠的深褐色液体被称为工业的血液地壳上层部分地区有石油储存主要成分是各种烷烃环烷烃芳香烃的混合物是地质勘探的主要对象之一1石油的成油机理有生物沉积变油和石化油两种学说前者较广为接受认为石油是古代海洋或湖泊中的生物经过漫长的演化形成属于生物沉积变油不可再生后者认为石油是由地壳内本身的碳生成与生物无关可再生石油主要被用来作为燃油和汽油也是许多化学工业产品如溶液化肥杀虫剂和塑料等的原料2古埃及古巴比伦人在很早以前已开采利用石油石油这个中文名称是由北宋科学家沈括第一次命名的3
比赛汉语词汇拼音bsi意思指在体育生产等活动中比较本领技术的高低	胜利汉语词汇拼音shngl意思指达到预期的目的与失败相对有成功的意思古代打仗成功称胜利比赛夺冠胜利称成功其他寓意也很广泛如一件事坚持到了最后也称胜利胜利在英语中都为victory
一年一度的体育运动比赛又要开始了你报名了三项运动分别是滑板自行车和卡丁车去争夺冠军吧	锦标本是锦制的标旗后泛指授给竞赛优胜者的奖品锦标赛ChampionshipsTournament指不同地区或竞赛大组的优胜者之间的一系列决赛之一锦标赛是排名在一定水平上的人才可以参加而且每个国家的选手数量限制比如世界羽毛球锦标赛里我们的选手排在前20的有的是而且理论上可以列为种子选手的人也应该大有人在但是由于有参赛人数的限制有些人就失去了机会如果他代表别的国家或许就是第一人锦标赛的地位和奖金积分等要比公开赛高很多因为它和奥运会的比赛一样是这个项目最高级别的个人赛事
性别是一个囊括了生物社会心理等学科的综合概念一方面性别指基于人类的男性女性间性等动物的雌雄雌雄同体等生物特征的解剖学上的身体差异即生理性别另一方面性别也指基于女性气质男性气质或者非二元气质的性别角色划分即社会性别1也就是说性别这一概念既有一定的生物学基础但也有复杂多样的社会学心理学等人文社会科学基础并非单纯的男女二元概念2中华人民共和国宪法2018修正中华人民共和国民法典2020中华人民共和国全国人民代表大会及地方各级人民代表大会选举法2015修正中华人民共和国妇女权益保障法2018修正等都明确认可了性别平等禁止性别歧视361995年第四届世界妇女大会在北京召开之后我国也正式将男女平等定为基本国策严格遵守北京宣言和行动纲领与世界联动保证性别平等工作的落实7中华人民共和国未成年人保护法2020修订规定学校幼儿园应当对未成年人开展适合其年龄的性教育8性别平等是全面性教育中的主题之一学习者不仅需要认识到性别平等的重要性还需要了解如何看待性别不平等性别刻板印象和偏见带来的负面影响以及如何建立基于性别平等的关系9	平等是指社会主体在社会关系社会生活中处于同等的地位具有相同的发展机会享有同等的权利包括1人格平等人们之间尽管存在性别民族职业经济状况生活等方面的差别但应当具有相同的价值和尊严处于相同的社会地位2机会平等每个人都有创造物质财富和精神财富的潜在能力必须清除各种人为的障碍制止任何人对各种机会的垄断和特权使人潜能的实现具有同等的机会和环境机会平等表现在经济领域要求等价交换和自由竞争表现在政治领域则要求人人平等地参与政治活动社会的职位向所有的人开放等3权利平等人们在法律面前同等地享受权利当然也包含平等地承担义务任何人不得具有超越法律之上的特权社会的平等应当是人格平等机会平等和权利平等的统一平等既是衡量社会进步的尺度又是一个社会在形式上所要追求的价值原则和道德理想1
旅程指旅途从一地到另一地的旅行路程1	指飞机的续航距离船舶中途不补充燃料可以运行的最大距离
耶路撒冷阿拉伯语英语Jerusalem希伯来语拉丁语Yerushalayim或Yerushalaim是以色列和巴勒斯坦共有的首都双方都有争议和政治经济文化和交通中心是耶路撒冷区的首府原巴勒斯坦最大城市耶路撒冷是犹太教基督宗教包括天主教新教东正教伊斯兰教包括逊尼派什叶派的圣地耶路撒冷位于近东黎凡特地区是一座历史悠久的城市在地理上位于犹大山地介于地中海与死海之间被誉为世界三大宗教的圣城犹太教基督教和伊斯兰教耶路撒冷是巴勒斯坦的首都1980年以色列立法认定耶路撒冷是该国永远的和不可分割的首都而后1988年巴勒斯坦自治政府宣布耶路撒冷是巴勒斯坦国的首都耶路撒冷由以色列实际控制耶路撒冷面积只有126平方公里著名景点有犹太教的哭墙和圣殿山穆斯林的圆顶清真寺和阿克萨清真寺以及基督徒的圣墓教堂和苦路耶路撒冷在历史上多次被外族人破坏也多次重新修建既是世界瞩目也是命运多舛的城市2019年12月26日位列2019年全球城市500强榜单第305名1	以色列国TheStateofIsrael简称以色列位于亚洲西部东接约旦东北部与叙利亚为邻南连亚喀巴湾西南部与埃及为邻西濒地中海北与黎巴嫩接壤是亚非欧三大洲结合处属地中海气候地势东高西低根据1947年联合国关于巴勒斯坦分治决议的规定以色列国的面积为15200平方千米目前实际控制面积约25000平方千米海岸线长198千米3建国时首都为特拉维夫1950年迁往耶路撒冷但未获国际社会普遍承认截至2021年12月以色列总人口为945万人4犹太人远祖是古代闪族支脉起源于约4000年前的美索不达米亚平原后因躲避自然灾害迁徙至埃及尼罗河三角洲东部因而得名希伯来人意为渡来之人公元前13世纪末开始从埃及迁居巴勒斯坦地区公元前1000年左右建立以色列国此后先后被亚述巴比伦波斯古希腊和罗马帝国征服公元70年被罗马人赶出巴勒斯坦地区开始长达近2000年的大流散19世纪末犹太复国主义运动兴起犹太人开始大批移居巴勒斯坦地区1947年11月29日联合国大会通过决议决定在巴勒斯坦地区分别建立一个阿拉伯国和一个犹太国1948年5月14日以色列国根据该决议正式成立3以色列是发达国家属混合型经济工业化程度较高以知识密集型产业为主高附加值农业生化电子军工等部门技术水平较高以色列总体经济实力较强竞争力居世界先列32020年以色列国内生产总值为为401954亿美元4
旅程是2019年贵州人民出版社出版的图书作者是九儿本书是一本无字绘本	汽车是2019年辽宁少年儿童出版社出版的图书1
医院Hospital一词来自拉丁文原意为客人因为一开始设立时是供人避难还备有休息间使来者舒适有招待意图后来才逐渐成为满足人类医疗需求提供医疗服务的专业机构收容和治疗病人的服务场所医院是指按照法律法规和行业规范为病员开展必要的医学检查治疗措施护理技术接诊服务康复设备救治运输等服务以救死扶伤为主要目的的医疗机构其服务对象不仅包括有症状的病员和伤员也包括不能自理或活动受限有医疗护理依赖的老年人法医评定有医疗护理依赖或病情不稳定需要长期康复经常观察检查的重度病伤员或有其他特定的情况和人群如健康人如孕妇产妇新生儿以及完全健康的人如来医院进行体格检查或口腔清洁的人最初设立时是供人避难还备有娱乐节目使来者舒适有招待意图后来才逐渐成为收容和治疗病人的专门机构中华人民共和国2021年国民经济和社会发展统计公报显示2021年末年末全国共有医院医院36570个78	基础设施infrastructurebasicfacilities是指为社会生产和居民生活提供公共服务的物质工程设施是用于保证国家或地区社会经济活动正常进行的公共服务系统它是社会赖以生存发展的一般物质条件基础设施包括交通邮电供水供电商业服务科研与技术服务园林绿化环境保护文化教育卫生事业等市政公用工程设施和公共生活服务设施等它们是国民经济各项事业发展的基础在现代社会中经济越发展对基础设施的要求越高完善的基础设施对加速社会经济活动促进其空间分布形态演变起着巨大的推动作用建立完善的基础设施往往需较长时间和巨额投资对新建扩建项目特别是远离城市的重大项目和基地建设更需优先发展基础设施以便项目建成后尽快发挥效益
杯子是一种专门盛水的器皿其主要功能都是用来饮酒或饮茶一般容积不大或在古代喝茶的杯子被称为盖碗基本器型大多是直口或敞口口沿直径与杯高近乎相等有平底圈足或高足考古资料表明最早的杯始见于新石器时代无论是在仰韶文化龙山文化还是河姆渡文化遗址中都见有陶制杯的存在这一时期杯型最为奇特多样带耳的有单耳或双耳杯带足的多为锥形三足杯觚形杯高柄杯等等根据制作材料不同可以分为玻璃杯塑料杯陶瓷杯木杯等2	手工艺品俗称民间手工艺品是指民间的劳动人民为适应生活需要和审美要求就地取材以手工生产为主的一种工艺美术品手工艺品的品种非常繁多如皮具宋锦竹编草编手工刺绣蓝印花布蜡染手工木雕油纸伞泥塑剪纸服饰民间玩具等2017年12月1日公共服务领域英文译写规范正式实施规定手工艺品标准英文名为Handicrafts1
能源是1976年科学出版社出版的图书作者是严家其1	危机是译林出版社2010年出版的图书作者是罗宾库克
计算机computer俗称电脑是现代一种用于高速计算的电子计算机器可以进行数值计算又可以进行逻辑计算还具有存储记忆功能是能够按照程序运行自动高速处理海量数据的现代化智能电子设备由硬件系统和软件系统所组成没有安装任何软件的计算机称为裸机可分为超级计算机工业控制计算机网络计算机个人计算机嵌入式计算机五类较先进的计算机有生物计算机光子计算机量子计算机等计算机发明者约翰冯诺依曼计算机是20世纪最先进的科学技术发明之一对人类的生产活动和社会活动产生了极其重要的影响并以强大的生命力飞速发展它的应用领域从最初的军事科研应用扩展到社会的各个领域已形成了规模巨大的计算机产业带动了全球范围的技术进步由此引发了深刻的社会变革计算机已遍及一般学校企事业单位进入寻常百姓家成为信息社会中必不可少的工具计算机的应用在中国越来越普遍改革开放以后中国计算机用户的数量不断攀升应用水平不断提高特别是互联网通信多媒体等领域的应用取得了不错的成绩1996年至2009年计算机用户数量从原来的630万增长至6710万台联网计算机台数由原来的29万台上升至5940万台互联网用户已经达到316亿无线互联网有67亿移动用户其中手机上网用户达117亿为全球第一位	实验室LaboratoryLab1即进行实验的场所实验室是科学的摇篮是科学研究的基地科技发展的源泉对科技发展起着非常重要的作用实验室按归属可分为三类第一类是从属于大学或者是由大学代管的实验室第二类实验室属于国家机构有的甚至是国际机构第三类实验室直接归属于工业企业部门为工业技术的开发与研究服务
世纪是为中国共产党成立100周年深情献礼的大型原创交响芭蕾该舞蹈为5月23日于北京天桥剧场首演上演至5月30日1舞团试图以芭蕾这一国际艺术语汇融古汇今运用交响芭蕾的独特艺术表现形式配合恢弘壮美雄壮磅礴的交响音乐深情表现中华民族精神的当代传承讲述中国故事	年是中华民族的传统佳节她代表着团聚预示着美好由刘冰清作词王岩作曲的歌曲年在优美温馨的旋律中表达了老百姓对年的温暖情感通过歌手富有激情的演绎更传递了中国大地上年的浪漫美好画面年是回家时那暖暖的车票年是春晚的那首难忘今宵年是饭桌上的美味佳肴年是全家福里的温馨美好歌词朴实真挚旋律清新自然词曲作者将会用最接地气的音乐情怀伴您度过一个快乐幸福年歌手用最真挚的情感演绎陪您度过一个美丽中国年
设备CapitalItems是指工业购买者用在生产经营过程中的工业产品包括固定设备和辅助设备等固定设备是主要设备购买或建设过程要经过一个较长的决策过程1	制造商或称为生产厂商指创造产品的企业
电视是中国传媒大学出版社出版的图书作者是南野	广播是1973年科学出版社出版的图书作者是刘寿听
乙醇ethanol是一种有机化合物结构简式为CH3CH2OH或C2H5OH分子式为C2H6O俗称酒精1乙醇在常温常压下是一种易挥发的无色透明液体低毒性纯液体不可直接饮用乙醇的水溶液具有酒香的气味并略带刺激性味甘乙醇易燃其蒸气能与空气形成爆炸性混合物乙醇能与水以任意比互溶能与氯仿乙醚甲醇丙酮和其他多数有机溶剂混溶14乙醇可用于制造醋酸饮料香精染料燃料等医疗上常用体积分数为7075的乙醇作消毒剂乙醇在化学工业医疗卫生食品工业农业生产等领域都有广泛的用途8	化学chemistry是在原子分子水平上研究物质的组成结构性质转化及其应用的基础自然科学它源自生活和生产实践并随着人类社会的进步而不断发展7不同于研究尺度更小的粒子物理学与核物理学化学研究的原子分子离子团的物质结构和化学键分子间作用力等相互作用其所在的尺度是微观世界中最接近宏观的因而它们的自然规律也与人类生存的宏观世界中物质和材料的物理化学性质最为息息相关作为沟通微观与宏观物质世界的重要桥梁化学则是人类认识和改造物质世界的主要方法和手段之一
死亡是由DominicLaurenceJames执导的惊悚片EmilyHampshireEliasKoteasJohnPyperFergusonCaterinaMurino等出演于2010年上映	囚犯是由GeorgeBasha执导的电影由GeorgeBashaBrendanDonoghue等主演于2014年1月21日在澳大利亚上映
战斗汉语词语拼音是zhndu意思是斗争1	击败拼音jbi释义打败战胜的意思1
火星是由林冠吟作词作曲林冠吟演唱的一首歌曲收录在专辑我是火星人中这是一首流行风格的歌曲歌曲展现了林冠吟独特的嗓音和创作功力	科学家是由孙骁作词作曲坡上村乐队演唱的一首歌曲收录于乐队首张专辑夏天动物园里快要融化的冰棍儿1
石油输出国组织简称欧佩克OPEC亚非拉石油生产国为协调成员国石油政策反对西方石油垄断资本的剥削和控制而建立的国际组织1960年9月成立它的宗旨是协调和统一成员国石油政策维持国际石油市场价格稳定确保石油生产国获得稳定收入最高权力机构为成员国大会由成员国代表团组成负责制定总政策执行机构为理事会日常工作由秘书处负责处理另设专门机构经济委员会以协助维持石油价格的稳定该组织自成立以来与西方石油垄断资本坚持斗争在提高石油价格和实行石油工业国有化方面取得重大进展1现有13个成员国是阿尔及利亚安哥拉刚果赤道几内亚加蓬伊朗伊拉克科威特利比亚尼日利亚沙特阿拉伯阿拉伯联合酋长国委内瑞拉2总部设在奥地利维也纳3卡塔尔于2019年1月退出石油输出国组织欧佩克42020年1月1日厄瓜多尔退出石油输出国组织52022年9月5日欧佩克和非欧佩克产油国欧佩克表示欧佩克决定再次将石油产量每天削减10万桶因此10月恢复到8月的协议条款11当地时间2022年10月5日石油输出国组织欧佩克与俄罗斯等非欧佩克产油国各方已就未来原油产量达成共识将减产200万桶日12	国家是政治地理学名词从广义的角度国家是指拥有共同的语言文化种族领土政府或者历史的社会群体从狭义的角度国家是一定范围内的人群所形成的共同体形式学术界对于国家的组成要素有两种说法常见的观点有三要素说和四要素说有的学者认为国家由个3要素组成例如美国法学家汉斯凯尔森在1946年出版的法与国家的一般理论中评论说传统学说划分国家的三个要素国家的领土人民和权力6在此之后他在1952年出版的国际法原理中说传统学说把国家的个3要素概括为领土人民和由一个独立的和有实效的政府行使的权力7而美国法学家杰克逊认为国际法中普遍接受的国家的定义的必要要素是居民领土和有效的政府10有的学者认为国家由4个要素组成例如美国法学家克雷文认为国家资格的必要要素是定居的居民确定的领土有效的政府和独立11中国国际法学家王铁崖先生认为国际法中的国家应具备定居的人民确定的领土政府主权四个要素89在社会科学和人文地理范畴国家是指被人民文化语言地理区别出来的领土被政治自治权区别出来的一块领地一个领地或者邦国的人民跟特定的人有关联的地区一般国家行政管理当局是国家的象征它是一种拥有治理一个社会的权力的国家机构在一定的领土内拥有外部和内部的主权
爱汉语常用字1读作i最早见于金文2其本义是喜爱爱好意为对人或事有深挚的感情后来又引申出爱情爱惜贪等意思来说文解字解释为行走的样子可意为疼惜呵护对方为之奔波辛劳之义2019年11月20日汉语盘点2019活动启动清博大数据推荐的国内字为国爱治纪会3基本信息栏主要参考资料4	性现代汉语规范一级字常用字1读音为xng现在所知最早的性字为金文说文解字人之阳气性善者也从心生声2性字本义为人或事物本身所具有的能力作用等引申指性质思想感情等方面的表现又引申指男女或雌雄的特质又引申指有关生物生殖的等等3
杯子是一种专门盛水的器皿其主要功能都是用来饮酒或饮茶一般容积不大或在古代喝茶的杯子被称为盖碗基本器型大多是直口或敞口口沿直径与杯高近乎相等有平底圈足或高足考古资料表明最早的杯始见于新石器时代无论是在仰韶文化龙山文化还是河姆渡文化遗址中都见有陶制杯的存在这一时期杯型最为奇特多样带耳的有单耳或双耳杯带足的多为锥形三足杯觚形杯高柄杯等等根据制作材料不同可以分为玻璃杯塑料杯陶瓷杯木杯等2	液体Liquid是三大物质形态之一它没有确定的形状往往受容器的影响但它的体积在压力及温度不变的环境下是固定不变的液体分子间的距离较远分子运动也较剧烈分子间的吸引力较小增温或减压一般能使液体汽化成为气体
足球Football英Soccer美是一项以脚为主控制和支配球两支球队按照一定规则在同一块长方形球场上互相进行进攻防守对抗的体育运动项目因足球运动对抗性强战术多变参与人数多等特点故被称为世界第一运动1现代足球的前身起源于中国古代山东淄州今淄博市的球类游戏蹴鞠后经阿拉伯人由中国传至欧洲逐渐演变发展为现代足球现代足球始于英国21848年足球运动历史上第一部文字形式的规则剑桥规则诞生1863年10月26日英格兰成立了世界上第一所足球协会并统一了足球运动的竞赛规则31872年英格兰与苏格兰之间举行了足球史上第一次协会间的正式比赛1900年在第二届夏季奥林匹克运动会中足球被列入正式项目4足球在全球被广泛译为Football只有在美国等极少数国家被译为Soccer而Football在美国加拿大被指为美式橄榄球56足球的最高组织机构为国际足球联合会成立于1904年总部设于瑞士苏黎世中国最高组织机构是中国足球协会1955年1月3日成立于北京78	网球Tennis是球类运动项目之一有效网球运动场地是一个长方形长为2377米单打场地宽为823米双打场地宽为1097米中间隔有网比赛双方各占球场的一方球员用网球拍击球1网球运动孕育在法国诞生在英国普及和形成的高潮在美国其最早起源于1213世纪的法国1896年在雅典举行的第一届现代奥运会上网球的男子单打与双打被列为正式比赛后来由于国际奥委会和国际网球联合会在业余运动员问题上有分歧已经连续进行了7届的奥运会网球比赛项目被取消直到1984年的洛杉矶奥运会上网球才被列为奥运项目1988年在汉城奥运会上网球重新被列为正式比赛项目2网球最高级的组织机构为国际网球联合会1913年在法国巴黎成立中国的最高级组织机构为中国网球协会1953年在北京成立
观众读音为gunzhng汉语词语指观看节目或比赛表演等的人1	连续剧是电视剧中一种重要的形式每集演播全剧中的一段故事并在每集或每段故事结尾处留有悬念吸引观众连续收看连续剧的故事情节较为曲折复杂剧中人物往往数量较多主要人物和情节都是连贯的
学生也叫学子一般指正在学校学堂或其他学习地方受教育的人而在研究机构或工作单位如医院研究所学习的人也称学生根据学习的不同阶段我们可以把学生分为幼儿园学生小学生中学生高等院校学生大学生硕士研究生博士研究生等等学生是一种身份的名词具有学籍的人都统称学生	教授是一种高等教育体系中的职称多指在大学或社区学院中执教的资深教师与研究员但教授与研究员是有区别的教授有教课的任务而研究员则没有教授为大学教师职称的最高级别中文的教授两字则源于传教授业的字义是中国古代就使用的学官名称在中国汉代唐代的大学中都设此职位这个词语与英文没有关联日语中则与中文同用教授来称呼大学中的老师
行星是2019年广东教育出版社出版的图书1	月亮是2020年人民文学出版社出版的图书1
奢侈品是2010年7月哈尔滨出版社出版的图书作者是张玉斌叶轻舟李鹏	汽车是2019年辽宁少年儿童出版社出版的图书1
管理者是指在组织中直接参与和帮助他人工作的人管理者通过其地位和知识对组织负有贡献的责任因而能够实质性的影响该组织经营及达成成果的能力者现代观点强调管理者必须对组织负责而不仅仅是监督指导与管理者相对应的是非管理者	面试是通过书面面谈或线上交流视频电话的形式来考察一个人的工作能力与综合素质通过面试可以初步判断应聘者是否可以融入自己的团队是一种经过组织者精心策划的招聘活动1在特定场景下以面试官对应聘者的交谈与观察为主要手段由表及里测评应聘者的知识能力经验和综合素质等有关素质的考试活动面试是公司挑选职工的一种重要方法面试给公司和应聘者提供了进行双向交流的机会能使公司和应聘者之间相互了解从而双方都可更准确做出聘用与否受聘与否的决定2
耶路撒冷阿拉伯语英语Jerusalem希伯来语拉丁语Yerushalayim或Yerushalaim是以色列和巴勒斯坦共有的首都双方都有争议和政治经济文化和交通中心是耶路撒冷区的首府原巴勒斯坦最大城市耶路撒冷是犹太教基督宗教包括天主教新教东正教伊斯兰教包括逊尼派什叶派的圣地耶路撒冷位于近东黎凡特地区是一座历史悠久的城市在地理上位于犹大山地介于地中海与死海之间被誉为世界三大宗教的圣城犹太教基督教和伊斯兰教耶路撒冷是巴勒斯坦的首都1980年以色列立法认定耶路撒冷是该国永远的和不可分割的首都而后1988年巴勒斯坦自治政府宣布耶路撒冷是巴勒斯坦国的首都耶路撒冷由以色列实际控制耶路撒冷面积只有126平方公里著名景点有犹太教的哭墙和圣殿山穆斯林的圆顶清真寺和阿克萨清真寺以及基督徒的圣墓教堂和苦路耶路撒冷在历史上多次被外族人破坏也多次重新修建既是世界瞩目也是命运多舛的城市2019年12月26日位列2019年全球城市500强榜单第305名1	巴勒斯坦国阿拉伯语英语StateofPalestinePalestine简称巴勒斯坦是位于中东亚洲西部的一个国家加沙地带面积365平方公里约旦河西岸地区面积5884平方公里实际控制领土为2500平方公里巴勒斯坦分为约旦河西岸和加沙地带两部分根据巴计划与国际合作部1997年10月绘制的地图约旦河西岸分为8个省加沙地带分为5个省首都为耶路撒冷法定拉姆安拉实际截至2022年6月巴勒斯坦人口约1350万人其中加沙地带和约旦河西岸人口为510万2020年11月其余为在外的难民和侨民1巴勒斯坦古称迦南包括现在的以色列约旦加沙和约旦河西岸历史上犹太人和阿拉伯人都曾在此居住1988年11月15日巴勒斯坦全国委员会第19次特别会议通过独立宣言宣布接受联大第181号决议建立以耶路撒冷为首都的巴勒斯坦国1994年5月根据巴以双方达成的协议巴方在加沙杰里科等地实行有限自治1995年以后根据巴以双方陆续签署的协议巴方控制区逐渐扩大目前包括加沙地带全境和约旦河西岸部分土地总面积约2500平方公里1巴勒斯坦经济严重依赖外来援助经济发展受制于以色列巴以冲突持续对巴勒斯坦经济发展形成严重制约主要经济数据如下2020年主要经济数字国内生产总值GDP1556亿美元国内生产总值增长率1146人均国内生产总值约3239美元1
残疾根据商务印书馆第七版现代汉语词典中解释为肢体器官或其功能方面的缺陷2唐律疏议斗讼假有旧瞎一目为残疾更瞎一目成笃疾宋刑统户婚律曰一目盲两耳聋手无二指足无三指手足无大拇指秃疮无发久漏下重大瘿癌如此之类皆为残疾明清律将唐宋的残疾与废疾合称残废残疾在确定伤害的后果以定罪量刑时为一重要标准同时又是减免刑罚赋税徭役的依据之一唐律疏议斗讼诸斗殴折跌人支体及瞎其一目者徒三年1	死亡指丧失生命生命终止是生存的反面哲学上说死亡是生命结束而且所有的本来维持其存在存活的属性的丧失不可逆转的永久性的终止美国一项令人震惊的研究表明当人类的心脏停止跳动时大脑还会继续运作换言之人类的大脑会意识到自己已经死亡这个事实1
比赛汉语词汇拼音bsi意思指在体育生产等活动中比较本领技术的高低	击败拼音jbi释义打败战胜的意思1
媒介是天津社会科学院出版社出版的图书作者是白春生李鸿标著1	广播是1973年科学出版社出版的图书作者是刘寿听
美元UnitedStatesdollar货币缩写USDISO4217货币代码USD符号USA是美利坚合众国萨尔瓦多共和国巴拿马共和国厄瓜多尔共和国东帝汶民主共和国马绍尔群岛共和国密克罗尼西亚联邦基里巴斯共和国和帕劳共和国的法定货币流通的美元纸币是自1929年以来发行的各版钞票1792年美国铸币法案通过后出现当前美元的发行是由美国联邦储备系统控制自1913年起美国建立联邦储备制度发行联邦储备券现行流通的钞票中99以上为联邦储备券美元的发行主管部门是国会具体发行业务由联邦储备银行负责办理在二战以后欧洲大陆国家与美国达成协议同意使用美元进行国际支付此后美元作为储备货币在美国以外的国家广泛使用并最终成为国际货币1截止2021年12月16日晚10点里拉对美元汇率已经超过156创下新低2021年以来里拉对美元贬值幅度超过503	澳大利亚元英语AustralianDollar简写A或AUD是澳大利亚瑙鲁图瓦卢和基里巴斯的货币单位澳大利亚元在外汇市场上为交易量世界第五大的流通货币居美元欧元日元英镑之后占总交易量的62010年澳大利亚元正式取代瑞士法郎的国际地位成为全球第五大流通货币
领土汉语词汇拼音lngt释义名在一国主权管辖下的区域包括陆地领水领海和领空	千米拼音是qinm汉语词语意思是指长度单位俗称公里英文用kmkilometer表示
杯子是一种专门盛水的器皿其主要功能都是用来饮酒或饮茶一般容积不大或在古代喝茶的杯子被称为盖碗基本器型大多是直口或敞口口沿直径与杯高近乎相等有平底圈足或高足考古资料表明最早的杯始见于新石器时代无论是在仰韶文化龙山文化还是河姆渡文化遗址中都见有陶制杯的存在这一时期杯型最为奇特多样带耳的有单耳或双耳杯带足的多为锥形三足杯觚形杯高柄杯等等根据制作材料不同可以分为玻璃杯塑料杯陶瓷杯木杯等2	实体是一个网络用语具有具体而真实的形态或结构的事物能够为人们所感知与亲手接触从数据处理的角度看现实世界中的客观事物称为实体它是现实世界中任何可区分可识别的事物实体可以指人如教师学生等也可以指物如书仓库等它不仅可以指能触及的客观对象还可以指抽象的事件如演出足球赛等它还可以指事物与事物之间的的联系如学生选课客户订货等古希腊哲学家亚里士多德的一个重要哲学概念也是后来西方哲学史上许多哲学家使用的重要哲学范畴
电影是2002年2月1日出版的速成读本该书由约翰劳顿和亚当斯密联合撰写	评论家由安南德图克尔导演伊恩麦克莱恩马克斯特朗杰玛阿特登等参演的电影1
电影是2002年湖南文艺出版社出版的图书1	爆米花是2013年人民音乐出版社出版的图书1
杯子是一种专门盛水的器皿其主要功能都是用来饮酒或饮茶一般容积不大或在古代喝茶的杯子被称为盖碗基本器型大多是直口或敞口口沿直径与杯高近乎相等有平底圈足或高足考古资料表明最早的杯始见于新石器时代无论是在仰韶文化龙山文化还是河姆渡文化遗址中都见有陶制杯的存在这一时期杯型最为奇特多样带耳的有单耳或双耳杯带足的多为锥形三足杯觚形杯高柄杯等等根据制作材料不同可以分为玻璃杯塑料杯陶瓷杯木杯等2	物体指自然界客观存在的一切有形体的物质一般分有气态液态和固态
人口栏目由中央广播电视总台和国家卫生和计划生育委员会中国人口宣传教育中心承办节目开播于1987年前身中国人口2007年改为现名该节目是揭示生命奥秘传递生命科学探寻中国人口与经济人口与社会协调发展的一档专题栏目	发展发展是社会全面的进步包括物质文明精神文明与生态文明的进步人的素质提高与德智体能全面提升社会的可持续发展发展相对于增长而言增长狭义指的是按GDP来计算的国民收入提高经济总量增加经济规模扩大增长是直线的发展是系统的对称的全面的发展是价值的发展不是金钱的增长是效益的发展不是效率的增长是全面的发展不是片面的增长是辨证的发展不是线性的增长发展是人和自然人和社会这一代人和下一代人的对称和谐协调融合与可持续进步1发展指关于人类社会发展特别是社会主义经济社会发展科学的发展理念和发展理论科学发展观的第一要义中共十六大以来以胡锦涛为总书记的党中央围绕建设中国特色社会主义这个主题立足社会主义初级阶段基本国情总结我国发展实践借鉴国外发展经验适应新的发展要求继承和发展中央三代领导集体关于发展的重要思想提出了以人为本全面协调可持续发展的科学发展观词目发展拼音fzhn单词DevelopDeveloped发达Developing发展中Development发展是指一种连续发展是事物从出生开始的一个进步变化的过程是事物的不断更新不断的变化过程既有量的变化又有质的变化有正向的变化也有负向变化
和平是汉语词语拼音是hpng意思是没有战争没有敌视暴力行为的状态	气氛读音qfn汉语词语意思是特定环境中给人强烈感觉的景象或情调表现热烈气氛的四字词语有欢欢喜喜兴高采烈兴致勃勃欢呼雀跃欢欣鼓舞喜上眉梢眉开眼笑欢聚一堂
行星是由美国童书作家教育科普类图书的领军人物盖尔吉本斯所著的一本给幼儿和孩子阅读的科普类绘本书用简洁生动的语言搭配32张彩图给孩子们介绍了太阳系里的几大行星描述了它们的大小位置运转轨道以及我们对这些行星的探索等知识	天文学家天文学家是以天体以及天体运行规律为研究对象的著名人士代表性人物有古希腊天文学家泰勒斯阿里斯塔克斯喜帕恰斯近代的代表人物有伽利略开普勒等中国代表人物有张衡祖冲之徐光启现代有张钰哲等
杯子是一种专门盛水的器皿其主要功能都是用来饮酒或饮茶一般容积不大或在古代喝茶的杯子被称为盖碗基本器型大多是直口或敞口口沿直径与杯高近乎相等有平底圈足或高足考古资料表明最早的杯始见于新石器时代无论是在仰韶文化龙山文化还是河姆渡文化遗址中都见有陶制杯的存在这一时期杯型最为奇特多样带耳的有单耳或双耳杯带足的多为锥形三足杯觚形杯高柄杯等等根据制作材料不同可以分为玻璃杯塑料杯陶瓷杯木杯等2	饮料是供人饮用的液体它是经过定量包装的供直接饮用或按一定比例用水冲调或冲泡饮用的乙醇含量质量分量不超过05的制品饮料也可分为饮料浓浆或固体形态它的作用是解渴补充能量等功能2017年10月27日世界卫生组织国际癌症研究机构公布的致癌物清单初步整理参考高于65C的很热的饮料饮用在2A类致癌物清单中1
月暗Moondark即魔术师Magician是美国漫威漫画旗下超级反派初次登场于漫威漫画团队MarvelTeamup第12期1978年3月是一名邪恶的魔术师月暗Moondark先后和蜘蛛侠SpiderMan恶灵骑士GhostRider还有暗夜狼人WerewolfbyMidnight等英雄交锋1	巫师Wizard是美国漫威漫画旗下超级反派初次登场于奇异故事StrangeTales第102期1962年11月本名宾利惠特曼BentleyWittman是一名天才发明家也是恐惧四魔FrightfulFour的创造者
心理学是华中科技大学出版社出版的一本图书作者是李宁主要讲述了心理学的基础理论和知识1	头脑领悟和智力器官的所在1思考能力脑筋如领悟这个论点需要有头脑需要教育2头绪条理如摸不着头脑1
博物馆是一首由苏打绿演唱的歌曲收录在专辑冬未了中	剧院是任大卫的一首诗歌收录于诗集火车和其他
谋杀是一项普通法罪行即如果一个人被他人蓄意以任何方法非法杀死或使他严重受伤后死亡则会犯下罪行基于生命权是行使一切权利的基础且一旦丧失无法恢复谋杀在所有普通法国家中都是最严重的刑事罪行之一该罪的最高法定刑即为该国刑法所允许的最高刑罚例如死刑终身监禁或法定最高监禁年期	误杀是法律用语指主观上无杀人意图因为失误而伤人致死也可称为过失致人死亡具体是指行为人实施行为时应当预见到自己的行为可能导致他人死亡的结果但是因疏忽大意而没有预见或者是已经预见但是轻信能够避免死亡的结果
夏天是李荣春创作的歌曲发行于2010年7月	自然是台湾男歌手郭岷勤的一张音乐专辑收录18首歌曲发行于2017年05月15日
记录是辽海出版社出版的图书作者是申晋书1	数字是2013年未来出版社出版的图书作者是权惠娟1
行星是2016年新蕾出版社出版的图书	太空是2021年青岛出版社出版的图书1
产品是指被人们使用和消费并能满足人们某种需求的任何东西包括有形的物品无形的服务组织观念或它们的组合产品一般可以分为五个层次即核心产品基本产品期望产品附加产品潜在产品核心产品是指整体产品提供给购买者的直接利益和效用基本产品即是核心产品的宏观化期望产品是指顾客在购买产品时一般会期望得到的一组特性或条件附加产品是指超过顾客期望的产品潜在产品指产品或开发物在未来可能产生的改进和变革产品是一组将输入转化为输出的相互关联或相互作用的活动的结果即过程的结果在经济领域中通常也可理解为组织制造的任何制品或制品的组合在现代汉语词典当中的解释为生产出来的物品简单来说是为了满足市场需要而创建的用于运营的功能及服务就是产品产品是以使用为目的物品和服务的综合体产品的价值是由用户来衡量的	员工是指企业单位中各种用工形式的人员包括固定工合同工临时工以及代训工和实习生现代单位的员工跟以往比较有很大的不同他们的素质相对比较高知识性强
问题是2003年中央编译出版社的出版图书1	挑战是2020年上海文艺出版社出版的图书1
受害者是指受侵害的一方包含人身财产等各方面的合法权益在新闻与法律条律中较为多见但还没有较明确的定义受害者一词虽常见于新闻与法律法条中但并不专指构成刑事案件的侵害任何合法权益受侵害的都可以称之为受害者	紧急状态是指发生或者即将发生特别重大突发事件需要国家机关行使紧急权力予以控制消除其社会危害和威胁时有关国家机关按照宪法法律规定的权限决定并宣布局部地区或者全国实行的一种临时性的严重危急状态在紧急状态下各国的法律都有相应规定政府可以采取特别措施来限制社会成员一定的行动政府还有权强制有关公民有偿提供一定劳务或者财物社会成员也有义务配合政府紧急状态下采取的措施来应对和解除突发事件2020年3月美国总统特朗普就新冠肺炎疫情举行新闻发布会宣布美国进入紧急状态12022年1月18日据新西兰驻汤加高级专员公署发布的消息汤加副首相波阿西泰伊宣布国家进入紧急状态该国通讯依然处于中断状态42月18日乌克兰东部民间武装宣布因存在乌克兰发起军事行动的危险即日起向俄罗斯大规模集中疏散当地居民而由于从乌克兰东部涌入的民众人数持续增加俄罗斯南部罗斯托夫州州政府19日宣布即日起进入紧急状态5当地时间2月24日乌克兰总统泽连斯基表示乌克兰国家安全与国防委员会进入紧急状态运行已动员所有军事力量和特种部队6当地时间2022年8月12日由于缺水加拿大努纳武特地区首府伊卡卢伊特Iqaluit宣布进入紧急状态46
政府是指国家进行统治和社会管理的机关是国家表示意志发布命令和处理事务的机关实际上是国家代理组织和官吏的总称政府的概念一般有广义和狭义之分广义的政府是指行使国家权力的所有机关包括立法行政和司法机关狭义的政府是指国家权力的执行机关即国家行政机关1政府是维护国家安全与主权加强国防建设消除社会隐患和内部腐败控制污染保护生态环境推广吸收民间先进科学技术和经验鼓励创新创造淘汰落后产品产能和生产工艺提高国民生产能力优化社会结构研究社会现象培养领导实施城乡规划开展破除迷信减贫扶贫防贫促进社会进步的特殊机构国家公共行政权力的象征承载体和实际行为体政府发布的行政命令行政决策行政法规行政司法行政裁决行政惩处行政监察等等都应符合宪法和有关法律的原则和精神都对其规定的所有适用对象产生效力并以国家武装力量为后盾的强制执行广义的政府是指国家的立法机关行政机关和司法机关等公共机关的总合代表着社会公共权力政府可以被看成是一种制定和实施公共决策实现有序统治的机构它泛指各类国家公共权力机关包括一切依法享有制订法律执行和贯彻法律以及解释和应用法律的公共权力机构即通常所谓的立法机构行政机构和司法机构从这个意义上说政府就是国家的权威性的表现形式	危机读音wij汉语词语意思是有危险祸害的时刻是给测试决策和问题解决能力的一刻是人生团体社会发展的转折点生死攸关利益转移有如分叉路
心理学是2015年浙江大学出版社出版的图书1	医生是12016年湖南教育出版社出版的图书
小伙子是SupperMoment演唱的一首中文歌曲收录于专辑小伙出城记1	兄弟是由歌手Cblock演唱的歌曲该歌曲收录在歌曲合辑中1
改变是2019年江苏文艺出版社出版的图书1	态度是2011年文化艺术出版社出版图书作者是王宁
部署是一个动词读音为bsh指安排布置处理料理语出史记项羽本纪梁部署吴中豪杰为校尉候司马	出发是一首歌曲陈敬容原唱1
图像是人类视觉的基础是自然景物的客观反映是人类认识世界和人类本身的重要源泉图是物体反射或透射光的分布像是人的视觉系统所接受的图在人脑中所形成的印象或认识照片绘画剪贴画地图书法作品手写汉字传真卫星云图影视画面X光片脑电图心电图等都是图像1	表面是一个汉语词语读音是biomin是指人或事物的外表最外层
开始是1999年丁薇演唱的一首歌曲收录于专辑开始中1	比赛是电视剧功夫足球的主题曲由张卫健演唱发行于2004年
本书是生活读书新知三联书店出版的丛书动物系列中的一部作者是苏茜格林	猫是2010年生活读书新知三联书店出版的图书本书是生活读书新知三联书店出版的丛书动物系列中的一部作者是瑟琳蒙泽尔罗杰斯1
老虎是2021年安徽少年儿童出版社出版的图书作者是伊拉古坚科1	动物园是2021年四川人民出版社出版的图书1
心理学是一门研究人类心理现象及其影响下的精神功能和行为活动的科学兼顾突出的理论性和应用实践性心理学包括基础心理学与应用心理学其研究涉及知觉认知情绪思维人格行为习惯人际关系社会关系人工智能IQ性格等许多领域也与日常生活的许多领域家庭教育健康社会等发生关联心理学一方面尝试用大脑运作来解释个体基本的行为与心理机能同时心理学也尝试解释个体心理机能在社会行为与社会动力中的角色另外它还与神经科学医学哲学生物学宗教学等学科有关因为这些学科所探讨的生理或心理作用会影响个体的心智实际上很多人文和自然学科都与心理学有关人类心理活动其本身就与人类生存环境密不可分心理学家从事基础研究的目的是描述解释预测和影响行为应用心理学家还有第五个目的提高人类生活的质量这些目标构成了心理学事业的基础心理学符号在希腊语里是灵魂的意思后来变成英文psyche	以抑郁为特征的疾病状态其特点为情绪低落思维缓慢语言动作减少和迟缓其发作形式轻型抑郁症无精神病症状抑郁症有精神病症状抑郁症复发性抑郁症见抑郁症抑郁性神经症F341depressiveneurosisICD10指出从前是指没有明显内源性抑郁症状而是与应激事件有因果联系以及与适应不良的人格有关现有证据表明没有同质的临床病种符合所有标准CCMD3不用这一名词见内源性抑郁症恶劣心境抑郁发作的表现可分为核心症状心理症状群与躯体症状群三个方面
部署是一个动词读音为bsh指安排布置处理料理语出史记项羽本纪梁部署吴中豪杰为校尉候司马	撤回汉语词汇拼音chhu释义指撤退回来撤退回到
阿拉法特是中国少年儿童出版社出版的图书作者是舒风著1	和平是外文出版社出版的图书作者是吴根友著1
计算机computer俗称电脑是现代一种用于高速计算的电子计算机器可以进行数值计算又可以进行逻辑计算还具有存储记忆功能是能够按照程序运行自动高速处理海量数据的现代化智能电子设备由硬件系统和软件系统所组成没有安装任何软件的计算机称为裸机可分为超级计算机工业控制计算机网络计算机个人计算机嵌入式计算机五类较先进的计算机有生物计算机光子计算机量子计算机等计算机发明者约翰冯诺依曼计算机是20世纪最先进的科学技术发明之一对人类的生产活动和社会活动产生了极其重要的影响并以强大的生命力飞速发展它的应用领域从最初的军事科研应用扩展到社会的各个领域已形成了规模巨大的计算机产业带动了全球范围的技术进步由此引发了深刻的社会变革计算机已遍及一般学校企事业单位进入寻常百姓家成为信息社会中必不可少的工具计算机的应用在中国越来越普遍改革开放以后中国计算机用户的数量不断攀升应用水平不断提高特别是互联网通信多媒体等领域的应用取得了不错的成绩1996年至2009年计算机用户数量从原来的630万增长至6710万台联网计算机台数由原来的29万台上升至5940万台互联网用户已经达到316亿无线互联网有67亿移动用户其中手机上网用户达117亿为全球第一位	新闻1也叫消息资讯是通过报纸电台广播电视台等媒体途径所传播信息的2一种称谓是记录社会传播信息反映时代的一种文体新闻概念有广义与狭义之分就其广义而言除了发表于报刊广播互联网电视上的评论与专文外的常用文本都属于新闻之列包括消息通讯特写速写有的将速写纳入特写之列等等3狭义的新闻则专指消息消息是用概括的叙述方式比较简明扼要的文字迅速及时地报道国内外新近发生的有价值的事实让别人了解每则新闻一般包括标题电头导语主体背景和结语六部分前四者是主要部分后二者是辅助部分标题导语主体必不可少写法上主要是叙述有时兼有议论描写评论等新闻是包含海量资讯的新闻服务平台真实反映每时每刻的重要事件可以通过查看新闻事件热点话题人物动态产品资讯等快速了解它们的最新进展4
阿拉法特是中国少年儿童出版社出版的图书作者是舒风著1	恐怖2005年上海人民出版社出版的图书1
中国国家最新标准汽车和挂车类型的术语和定义GBT373012001中对汽车有如下定义由动力驱动具有4个或4个以上车轮的非轨道承载的车辆主要用于载运人员和或货物牵引载运人员和或货物的车辆特殊用途国产汽车品牌有集度五菱宝骏红旗长安长城奇瑞吉利荣威比亚迪蔚来小鹏汽车东风等国外汽车品牌有丰田大众奥迪奔驰现代起亚标致凯迪拉克日产等	航班是指以航空器从事乘客邮件或货物的公共运输的任何定期航班也指某一班次的客轮或客机或客轮或客机航行的班次由各个航空公司的两字代码加4位数字组成航空公司代码由民航局规定公布后面的四位数字第一位代表航空公司的基地所在地区第二位表示航班的基地外终点所在地区1为华北2为西北3为华南4为西南5为华东6为东北8为厦门9为新疆第三第四位表示这次航班的序号单数表示由基地出发向外飞的去程航班双数表示飞回基地的回程航班
聪明是汉语词语拼音是cngmngcngming意思是用来表达对待人事物有着好的想法和正确的逻辑一般是用来赞美的词语	学生也叫学子一般指正在学校学堂或其他学习地方受教育的人而在研究机构或工作单位如医院研究所学习的人也称学生根据学习的不同阶段我们可以把学生分为幼儿园学生小学生中学生高等院校学生大学生硕士研究生博士研究生等等学生是一种身份的名词具有学籍的人都统称学生
心理学是2006年10月01日人民邮电出版社出版发行的图书作者是美戴维迈尔斯1	恐惧2004年01月由江苏人民出版社出版发行的图书作者是弗兰克富里迪1
皮肤是福茂唱片发行于2013年10月的一首国语流行歌曲由陈势安演唱所属专辑为非你不可	眼睛是由歌手张敬轩作词作曲并演唱的一首歌曲收录在张敬轩2004年11月1日发行的专辑AmPm中12
发现是2018年北岳文艺出版社出版的图书1	太空是2021年青岛出版社出版的图书1
杯子是宋剑伍写的一首诗	物质是金朝刁白的创作的一首诗
墨西哥合众国西班牙语EstadosUnidosMexicanos英语UnitedMexicanStates简称墨西哥领土面积19644万平方公里是拉丁美洲第三大国位居世界第十四位位于北美洲南部拉丁美洲西北端墨西哥全国总人口128亿2020年印欧混血人和印第安人占总人口的90以上全国划分为32个州首都墨西哥城已由联邦区改为州州下设市镇和村首都为墨西哥城CiudaddeMxico1墨西哥是美洲大陆印第安人古文化中心之一1521年沦为西班牙殖民地11821年墨西哥独立战争后建立墨西哥第一帝国1823年被军事政变推翻1824年建立墨西哥合众国1848年美墨战争后被迫将位于北部的近三分之一领土割让给美国11863年在法国的扶持下建立墨西哥第二帝国1910年爆发墨西哥革命推翻了独裁统治最终促成了1917年宪法的制定和现行政治体制的建立1墨西哥是拉美经济大国美墨加协定原北美自由贸易区成员世界最开放的经济体之一同50个国家签署了自贸协定据统计2020年国内生产总值104万亿美元同比下降9人均国内生产总值8400美元通胀率34失业率382020年12月底外汇储备19567亿美元1	巴西联邦共和国葡萄牙语RepblicaFederativadoBrasil英语TheFederativeRepublicofBrazil简称巴西Brazil1国土总面积85149万平方公里是南美洲最大的国家1居世界第五2总人口21亿2020年与乌拉圭阿根廷巴拉圭玻利维亚秘鲁哥伦比亚委内瑞拉圭亚那苏里南法属圭亚那十国接壤全国共分为26个州和1个联邦区1巴西原为印第安人居住地1500年4月22日葡萄牙航海家佩德罗阿尔瓦雷斯卡布拉尔抵达巴西16世纪30年代沦为葡萄牙殖民地11808年拿破仑入侵葡萄牙葡王室流亡巴西拿破仑战败后葡王室重回里斯本王子佩德罗则留在巴西担任摄政11822年9月7日佩德罗王子宣布巴西脱离葡萄牙独立称佩德罗一世建立巴西帝国1889年11月15日丰塞卡将军发动政变推翻帝制成立巴西合众国1964年3月31日军人执政实行独裁统治1967年改为现国名1985年1月军政府下台1989年首次以全民直接选举方式举行大选1巴西是里约集团南方共同市场南美进步论坛和20国集团成员国与阿根廷和智利并称为ABC国家1巴西是金砖国家之一拥有丰富的自然资源和完整的工业基础国内生产总值位居南美洲第一为世界第七大经济体3足球是巴西人文化生活的主流运动因此巴西享有足球王国的美誉1
消费者指的是不能利用无机物质制造有机物质的生物其不能直接利用太阳能来生产食物只能直接或间接地依赖于生产者所制造的有机物质的异养生物1消费者不仅对初级生产物起着加工再生产的作用而且许多消费者对其他生物种群起着重要的调控作用在生态系统物质循环和能量流动中也起着重要的作用促进了整个生态系统循环和发展维持着生态系统的稳定1	能源是指能够提供能量的资源这里的能量通常指热能电能光能机械能化学能等可以为人类提供动能机械能和能量的物质能源按来源可分为三大类1来自太阳的能量包括直接来自太阳的能量如太阳光热辐射能和间接来自太阳的能量如煤炭石油天然气油页岩等可燃矿物及薪材等生物质能水能和风能等2来自地球本身的能量一种是地球内部蕴藏的地热能如地下热水地下蒸汽干热岩体另一种是地壳内铀钍等核燃料所蕴藏的原子核能3月球和太阳等天体对地球的引力产生的能量如潮汐能1
行星是由王大辉作词陈大创作曲大籽演唱的歌曲收录于同名专辑行星发行于2020年8月23日1	歌曲太阳由郑宜农作词作曲并演唱于2011年7月8日发行收录于专辑海王星1
期刊定期出版的刊物如周刊旬刊半月刊月刊季刊半年刊年刊等由依法设立的期刊出版单位出版刊物期刊出版单位出版期刊必须经新闻出版总署批准持有国内统一连续出版物号领取期刊出版许可证	协会是指由个人单个组织为达到某种目标通过签署协议自愿组成的团体或组织中文将英语Association译作协会和工会组织的概念不同协会常指包括职业雇主行业学术和科学等方面为达成某种目标而成立的组织工会多指被雇用者为确保自身权益特别是经济利益而成立的组织多集中于雇佣者和被雇佣者的关系
医生钻研学习医学科学技术挽救生命以治病为业的人一般指临床医师按照卫生部卫健委医政部有关医疗卫生管理条例的法律法规主持医患沟通学术讨论新技术推广预后分析公众教育护理示教康复培训出院教育执行卫生防疫计生大病早期识别干预等法律政治责任承担部分课题研究等工作预防出生缺陷提高人口素质治病救人履行病情如实告知合理检查合理开药正确诊断积极治疗的责任提高医生职业风险和医疗事故安全法律意识避免误诊漏诊控制医源性继发损害纠正违章作业等法律责任通过定期临床理论考试技能考核培训能够熟练掌握临床必要的医学技能和必要的医学理论如影像学解剖学病理学医学遗传学药物化学康复医学生育保健学临床法医学等取得执业资格不得夸大病情吓唬病人延误时机造成事故要按照行业规范开展诊疗活动医生古代称大夫或郎中新中国成立后我国涌现了大量赤脚医生一度达到150多万名现在大夫一词在北方人中也常用在欧美医生普遍被称为Physician只有外科医生被称呼为Surgeon外科医生的法语称呼为DecinMedusan德语是Arztarutsuto但在英联邦英国外科医生今天还以密司脱称呼	人员读作rnyun汉语词汇通常指受雇的人的整体如在一个工厂办公室或组织机构内或者担任某种工作或某种职务的人1人员近义人士也可比如各界人士也代表各种人员
美元UnitedStatesdollar货币缩写USDISO4217货币代码USD符号USA是美利坚合众国萨尔瓦多共和国巴拿马共和国厄瓜多尔共和国东帝汶民主共和国马绍尔群岛共和国密克罗尼西亚联邦基里巴斯共和国和帕劳共和国的法定货币流通的美元纸币是自1929年以来发行的各版钞票1792年美国铸币法案通过后出现当前美元的发行是由美国联邦储备系统控制自1913年起美国建立联邦储备制度发行联邦储备券现行流通的钞票中99以上为联邦储备券美元的发行主管部门是国会具体发行业务由联邦储备银行负责办理在二战以后欧洲大陆国家与美国达成协议同意使用美元进行国际支付此后美元作为储备货币在美国以外的国家广泛使用并最终成为国际货币1截止2021年12月16日晚10点里拉对美元汇率已经超过156创下新低2021年以来里拉对美元贬值幅度超过503	利润是企业家的经营成果是企业经营效果的综合反映也是其最终成果的具体体现1
部长是指特指中央政府国务院部门的首长在政府首脑之下负责特定范畴工作如国防环境财政司法教育等担负起政府运作的重责大任在实行内阁制的国家地区部长是内阁的构成成员故又被称为阁员或阁臣如国家体制为君主制则通常称为大臣在中华人民共和国部长为中央人民政府国务院下属各部门的负责人一般由国务院总理提名全国人民代表大会任命国家主席签署主席令任命1中共中央任命23	政党指由一定阶级领导的并代表本阶级利益的社会政治组织政党有特定的政治目标和意识形态针对国家和社会议题有各自的主张定立政纲展示愿景1社会承认其具有组织与扩张其主张的合法权力其也积极介入到政治生活中为取得或维护政权或影响政治权力的行使而发挥自己的作用
股票是2004年科学出版社出版的图书作者是日杉村富生1	生活Life美国图画杂志1936年卢斯HenryRobinsonLuce18981967创办于纽约原为周刊1978年9月改月刊时代出版公司出版内容以专题照片特写为主题材广泛13
马拉松Marathon长跑是国际上非常普及的长跑比赛项目全程距离26英里385码折合为42195公里也有说法为42193公里分全程马拉松FullMarathon半程马拉松HalfMarathon和四分马拉松QuarterMarathon三种以全程马拉松比赛最为普及一般提及马拉松即指全程马拉松2022年9月25日在第48届柏林马拉松上肯尼亚名将埃鲁德基普乔格以2小时01分09秒完赛超越了此前由他本人保持的2小时01分39秒的世界纪录20	短跑是田径竞赛项目的其中一类一般包括50米跑60米跑100米跑200米跑400米跑4100米接力跑等几项其运动特性人们同时以最快的速度在田径跑道上跑完规定的距离并以最先跑完者为获胜者的项目在人体机能供能方面短跑表现为人体以最大限度地发挥人的速度极限本能并以无氧代谢供能的方式供能
聪明是由艾怡良创作词曲并演唱的歌曲收录于艾怡良2021年10月29日发行的专辑偏偏我却都记得中1	笨是吴日言演唱的一首歌曲由奥斯卡作词古驰作曲收录于2005年12月1日发行的专辑512Trio中
公告是指政府团体对重大事件当众正式公布或者公开宣告宣布国务院2012年4月16日发布2012年7月1日起施行的党政机关公文处理工作条例对公告的使用表述为适用于向国内外宣布重要事项或者法定事项其中包含两方面的内容一是向国内外宣布重要事项公布依据政策法令采取的重大行动等二是向国内外宣布法定事项公布依据法律规定告知国内外的有关重要规定和重大行动等	警告汉语词汇拼音jnggo释义一种警戒性的纪律制裁方式也是最轻微的一种制裁方式是指公务员的行为已经构成了违纪应当予以及时纠正和警示12017年12月1日公共服务领域英文译写规范正式实施规定警告标准英文名为Notice2
壁柜cabinet又称内嵌壁柜是指住宅套内与墙壁结合而成的落地或悬挂贮藏空间壁柜是指在墙体上留出空间而成的橱也叫作壁橱如果你的房里没有充足的空间容得下全尺寸的壁橱那麽一只吊衣柜或许就够用了这些吊衣柜也有许多样式可供选择多数是松木与挑花心木制的传统型式它们的外表看起来像个带抽屉的普通衣柜然而一打开便显露出挂衣服的空间而且也有抽屉的安排	衣服指穿在身上遮体御寒并起美化作用的物品今泛指身上穿的各种衣裳服装衣服的本意是指防寒保暖护身的介质在现代社会衣服成为人体的装饰物品更多是象征着一个人的生活水准消费层次和社会地位身份的参考品但同时也起到了原始不变的基本功能只是质地上的区别而已古代御寒之衣有裘袍茧等裘是皮衣毛朝外说文古者衣裘以毛为表兽毛外露不好看贵族在朝拜祭礼或待客时要罩上一件衣服称为裼衣裼衣根据不同身份不同的场合也有不同的形制和颜色
僧侣是多米尼克摩尔执导的悬疑片文森特卡索和黛博拉弗朗索瓦出演该片讲述了一位布道者相信自己不会被任何欲望诱惑而一名新来的女孩动摇了他的信念使他走上触犯原罪的道路的故事	摇钱树是斯蒂芬赫瑞克执导的喜剧片艾迪墨菲和杰夫高布伦出演该片讲述了一名天生具有领袖魅力的教徒发挥能言善道的天赋来吸引消费者的故事
利润是企业家的经营成果是企业经营效果的综合反映也是其最终成果的具体体现1	损失是一个汉语词汇读音为snsh指失去东西不会有补偿也指损毁丧失毁坏损失既可作动词也可作名词反义词是收益收获
和平是外文出版社出版的图书作者是吴根友著1	保险是2004年科学出版社出版的作品作者是上山道生
生活是一个汉语词语拼音是shnghu意思有1生存2使活命3指恤养活人4指为生存发展而进行各种活动5指为生存发展而进行各种活动的经验6指衣食住行等方面的情况境况7指生长8指家产生计9活儿工作10指生活费用11指用品器物12美事美好的时光13笔的别称1广义上指人的各种活动包括日常生活行为学习工作休闲社交娱乐等生活是比生存更高层面的一种状态	课拼音k是汉语通用规范一级字1最早见于战国文字本义是考核引申为检测征收赋税差派劳役学习作业等义2基本信息栏参考资料34
埋葬死人的地方坟地主要是指人去世后将遗体或骨灰式遗物统一集中到一个统一的地点这是人类发展历史上的文明和进步如今随着城市化的发展城市人口的增多公墓建设成为了城市发展的必然2018年9月7日民政部公布殡葬管理条例征求意见稿条例拟规定安葬骨灰的独立墓位占地面积不得超过05平方米1	林地是森林的载体是森林物质生产和生态服务的源泉是森林资源资产的重要组成部分森林法规定林地是指郁闭度02以上的乔木林地以及竹林地疏林地未成林造林地灌木林地采伐迹地火烧迹地苗圃地和县级以上人民政府规划的宜林地在进行经济效益评估时主要是对各类型林地面积及其价值进行评估12021年8月26日上午自然资源部召开新闻发布会公布第三次全国国土调查主要数据成果数据显示我国林地426亿亩2
学校英语School是指教育者有计划有组织地对受教育者进行系统的教育活动的组织机构名称起源于民国学校是由专职人员和专门机构承担的有目的有系统有组织的有计划的以影响受教育学校教育者的身心发展为直接目标并最终使受教育者的身心发展达到预定目的的社会活动学校教育指受教育者在各类学校内所接受的各种教育是教育制度的重要组成部分学校教育的具体活动受到社会需求影响必须符合社会发展趋势承担着对社会输送人才的职能一般说来学校教育包括学前教育初等教育中等教育和高等教育学校主要分为五种幼儿园小学初中高中和大学2016年全国共有各级各类学校512万所全国各级各类学校拥有校舍建筑面积总量达326亿平方米1截至2021年全国共有各级各类学校5371万所比上年增加070万所增长133各级各类学历教育在校生289亿人比上年增加67448万人增长239专任教师179297万人比上年增加6094万人增长3523截至2020年全国高等学校共计3005所其中普通高等学校2740所含本科院校1258所高职大专院校1482所成人高等学校265所本名单未包含港澳台地区高等学校2	中心汉语词汇拼音是zhngxn本义为与四周距离相等的位置常用来指在某一方面占重要地位的城市或地区也指具有某一特定主导功能的大型建筑物群1比如非常出名的日心说它认为太阳是太阳系的中心而不是地球当表示建筑物时应当具有某一特定主导功能占地面积在2万平方米以上且建筑面积在20万平方米以上须在通名前增加表示主导用途的词语1如某市国际XX中心
灾难汉语词汇拼音zinn释义为灾祸苦难灾难分为人为造成的和自然造成两种情况自然的严重损害带来对生命的重大伤害	足以把与一种现象相关或一个特殊条件影响所涉及的所有特征包含在内的足够大的一个地理区域1引自DLT520932010核电厂工程勘测技术规程第3部分水文气象
维护是指维以护之免受外害比如将人群居住地周围蓄养牲畜的周围以及其他重要物体场所周围设置带有保护性的设施以防止外界的侵害维护也为通信术语之一	世界world广义上来讲就是指全部所有一切一般来讲世界指的是人类赖以生存的地球世界还代称的有天地天下此岸世间万物世上等世界也可解释由可感知的不可感知的客观存在的总和以及用于描述客观存在及其相互关系的概念总和客观存在是不以人或其他物意志转移而存在的世界由概念世界和物质世界组成概念世界包含所有生命对客观世界的认知以及为记录认知而存在的事物的总和
白天男汉族1957年5月出生山西平定人1974年2月参加工作1986年6月加入中国共产党大学学历现任吕梁市发改委总经济师	夏天男汉族1978年5月生吉林九台人2003年11月参加工作1996年4月入党研究生学历经济学硕士学位现任共青团黑龙江省委副书记1
偏见是2019年人民文学出版社出版的图书1	认知是2019年中国人口出版社出版的图书1
联邦调查局是一本都市小说作者是罗尘1	指纹本名韩冰北京人律师1系网剧白夜追凶编剧2庭外编剧13重生编剧11
气氛读音qfn汉语词语意思是特定环境中给人强烈感觉的景象或情调表现热烈气氛的四字词语有欢欢喜喜兴高采烈兴致勃勃欢呼雀跃欢欣鼓舞喜上眉梢眉开眼笑欢聚一堂	景观一般意义上是指一定区域呈现的景象即视觉效果这种视觉效果反映了土地及土地上的空间和物质所构成的综合体是复杂的自然过程和人类活动在大地上的烙印生态学上景观是指由相互作用的拼块或生态系统组成以相似的形式重复出现的一个空间异质性区域是具有分类含义的自然综合体俄国地理学家把生物和非生物的现象都作为景观的组成部分这也为地理学与生态学的融合交叉打下了基础中国大百科全书地理学1990概括了地理学中对景观的几种理解某一区域的综合特征包括自然经济文化诸方面一般自然综合体区域单位相当于综合自然区划等级系统中最小的一级自然区任何区域单位
剧院是任大卫的一首诗歌收录于诗集火车和其他	历史是谭剑飞创作的一首现代诗歌
总统指统领晚清新官名	奖章拼音jingzhng是授予有功人员比赛成绩优异等的徽章
对于判例必须分别来看在民法法系判例是非正式的法律渊源除了个别情况外理论上不承认判例具有约束力在普通法法系判例是正式的法律渊源即判例法公共政策是有关必须达到集体目的或目标的一种政治决定这种决定一般来说旨在改善经济政治或者社会的境况或旨在促进整个社会的某种集体目标的实现事物性质实际上是一种知识或人们对事物内在规律的认识1	认知是汉语词汇拼音是rnzh认知是一种意识活动是个体认识客观世界的信息加工过程和结果对事物概念的判断和对某个范围内事物规律的总结这些总结对客观世界反映的程度代表对这个范围内事物认知的高低习惯上将认知与情感意志相对应感觉知觉记忆想象思维等是认知的载体和工具通过这些载体和工具实现认知的过程产生认知的结果个体认知的表达使得个体和环境产生相互作用
繁殖力表示动物生殖机能的强弱和生育后代的能力亦称生殖力由一系列生理现象和许多性能指标构成母畜为性成熟的时期发情周期的频率次数和季节性排卵数卵子受精率受胎率和每次受胎配种次数妊娠的建立和维持胚胎成活率妊娠持续期分娩情况产仔率分娩率每胎产仔数哺乳期长短哺育仔畜的能力产仔至再次繁殖的能力由于雌畜所产卵粒不是都能孵化那些能够孵化的卵粒数占其总卵粒数的百分比称为繁殖力决定仔畜孵化率的大小与多种因素有关如卵是否受精湿度是否合适其中温度的高低能直接影响其孵化率由无融合生殖形成的种子与果实12散布体产量及大小散布体产量是指每个母体在绝对单位时间年内产生的散布体数量多少散布体产量有时也被称为繁殖力	鸡蛋又名鸡卵鸡子是母鸡所产的卵鸡蛋里含量最高的是蛋白质蛋白质受热容易变性8鸡蛋含蛋白质多会加重胃肠负担72021年6月9日以色列文物管理局宣布在特拉维夫市附近发现一枚约1000年前的鸡蛋9
秘书Secretary可以指1政党之内的要职最高者称为总书记2写字楼及商业机构内的文员职位专长是速记打字安排日程会议订机票订酒店等3香港决策局的最高级公务员职位美国联邦政府的部长英文名称亦为总统的部会秘书如国务卿为SecretaryofState陆军部长为SecretaryofArmy平时称为部长先生MrSecretary	上议院HouseofLords是某些国家两院制议会的组成部分上议院有权否决下议院所通过的法案议员由间接选举产生或由国家元首指定任期比下议院议员长有的终身任职也有世袭上议院名称各国叫法不一如英国叫贵族院1美国日本叫参议院俄罗斯叫联邦委员会等2上议院法官必须有任高级司法官员两年的经历或已经从事高级出庭律师工作15年的经历1人数共十二名他们是带薪的通常从上诉法官中任命偶尔也从高等法院法官中任命上议院审理案件只涉及法律问题不涉及事实问题同时案件必须具有广泛的公众重要性
石油是清华大学出版社暨南大学出版社出版的图书作者是李德生著1	股票是2004年科学出版社出版的图书作者是日杉村富生1
美洲豹学名PantheraoncaLinnaeus1758又叫美洲虎是现存第三大的猫科动物体重35150千克最大亚种雄性亚马孙美洲豹平均体重为98千克咬力可达1250磅是生活在中南美洲的一种大型猫科动物它身上的花纹比较像豹但整个身体的形状又更接近于虎在猫科动物中美洲豹的体型仅次于狮虎野外寿命约18年人工饲养的历史达20多年列入世界自然保护联盟濒危物种红色名录IUCN2021年近危NT	猫属于猫科动物是全世界家庭中较为广泛的宠物家猫的祖先据推测是古埃及时期的沙漠猫波斯的波斯猫已经被人类驯化了3500年但未像狗一样完全地被驯化一般的猫头圆颜面部短前肢五指后肢四趾趾端具锐利而弯曲的爪爪能伸缩具有夜视性以伏击的方式猎捕其它动物大多能攀援上树猫的趾底有脂肪质肉垫以免在行走时发出声响捕猎时也不会惊跑鼠行进时爪子处于收缩状态防止爪被磨钝在捕鼠和攀岩时会伸出来
家庭family是一种以血缘为基础具有情感纽带的社会单元以共同的住处经济合作和繁衍后代为特征如今家庭的类型越来越丰富除了以异性恋血亲制度为特点的传统家庭还出现了如收养家庭寄养家庭单亲家庭同性家庭等多元的家庭形态在功能主义观点下家庭起到了经济生产再生产社会化和儿童抚养的功能在女性主义观点下家庭是性别不平等的高发领域之一这体现为家庭中劳动分工的不平等及家庭暴力高发等现象根据现有研究中国当代家庭变化的趋势是规模变小代数变少主要家庭模式趋于稳定但家庭形式更为多样家庭关系既亲密又疏远由于家庭观念的悠久传承和结构性因素的制约传统家庭的形式仍占据主导地位生养教化功能仍多由家庭承担尊重不同的家庭类型以及认识家庭养育和婚姻中的责任是全面性教育中的重要内容联合国国际性教育技术指导纲要修订版中提到儿童青少年应当了解不同类型的家庭并给予尊重了解爱与协作的重要性同时了解家庭成员之间不同的需求和角色以及在家庭成员的责任和角色分配上存在社会性别不平等	计划管理学术语拆解开计划的两个汉字来看计的表意是计算划的表意是分割计划从属于目标达成而存在计划的表意定义计划是分析计算如何达成目标并将目标分解成子目标的过程及结论在管理学中计划具有两重含义其一是计划工作是指根据对组织外部环境与内部条件的分析提出在未来一定时期内要达到的组织目标以及实现目标的方案途径其二是计划形式是指用文字和指标等形式所表述的组织以及组织内不同部门和不同成员在未来一定时期内关于行动方向内容和方式安排的管理文件
情况是一个名词读音为qngkung是指情形情景出自堕及妻赵氏墓志情况也有指事情的来龙去脉等意思	结论conclusionconsequenceresult拼音jiln意思是从逻辑学来看结论是从一定的前提推论得到的结果对事物做出的总结性判断
物理学physics是研究物质最一般的运动规律和物质基本结构的学科作为自然科学的带头学科物理学研究大至宇宙小至基本粒子等一切物质最基本的运动形式和规律因此成为其他各自然科学学科的研究基础物理学起始于伽利略和牛顿的年代它已经成为一门有众多分支的基础科学物理学是一门实验科学也是一门崇尚理性重视逻辑推理的科学物理学充分用数学作为自己的工作语言它是当今最精密的一门自然科学学科1	化学chemistry是在原子分子水平上研究物质的组成结构性质转化及其应用的基础自然科学它源自生活和生产实践并随着人类社会的进步而不断发展7不同于研究尺度更小的粒子物理学与核物理学化学研究的原子分子离子团的物质结构和化学键分子间作用力等相互作用其所在的尺度是微观世界中最接近宏观的因而它们的自然规律也与人类生存的宏观世界中物质和材料的物理化学性质最为息息相关作为沟通微观与宏观物质世界的重要桥梁化学则是人类认识和改造物质世界的主要方法和手段之一
韩国WIZET开发盛大网络代理运营的游戏冒险岛中的一个人物职业由魔法师转职而来主教是冒险岛中的灵魂人物不可或缺的职业	法师是游族网络出品的网页游戏女神联盟中的职业法师是元素的操纵者他们熟悉冰火雷元素并且运用自如通过操控魔法来获得强大的控制力和输出力法师通过转职可成为魔法师或秘法师1
杯子是一种专门盛水的器皿其主要功能都是用来饮酒或饮茶一般容积不大或在古代喝茶的杯子被称为盖碗基本器型大多是直口或敞口口沿直径与杯高近乎相等有平底圈足或高足考古资料表明最早的杯始见于新石器时代无论是在仰韶文化龙山文化还是河姆渡文化遗址中都见有陶制杯的存在这一时期杯型最为奇特多样带耳的有单耳或双耳杯带足的多为锥形三足杯觚形杯高柄杯等等根据制作材料不同可以分为玻璃杯塑料杯陶瓷杯木杯等2	食物英文Food是指能够满足机体正常生理和生化能量需求并能延续正常寿命的物质对人体而言能够满足人的正常生活活动需求并利于寿命延长的物质称之为食物食物通常是由碳水化合物脂肪蛋白质水构成能够藉进食或是饮用为人类或者生物提供营养或愉悦的物质食物的来源可以是植物动物或者其他界的生物例如真菌亦或发酵产品像是酒精人类借由采集耕种畜牧狩猎渔猎等许多种不同的方式获得食物
黄瓜学名CucumissativusL葫芦科一年生蔓生或攀援草本植物茎枝伸长有棱沟被白色的糙硬毛卷须细叶柄稍粗糙有糙硬毛叶片宽卵状心形膜质裂片三角形有齿雌雄同株雄花常数朵在叶腋簇生花梗纤细被微柔毛花冠黄白色花冠裂片长圆状披针形雌花单生或稀簇生花梗粗壮被柔毛子房粗糙果实长圆形或圆柱形熟时黄绿色表面粗糙种子小狭卵形白色无边缘两端近急尖花果期夏季中国各地普遍栽培且许多地区均有温室或塑料大棚栽培现广泛种植于温带和热带地区黄瓜为中国各地夏季主要菜蔬之一茎藤药用能消炎祛痰镇痉1概述图片来源2	落花生学名ArachishypogaeaLinn豆科落花生属的一年生草本植物根部有丰富的根瘤茎和分枝均有棱叶纸质对生叶柄基部抱茎卵状长圆形至倒卵形先端钝圆形两面被毛边缘具睫毛叶脉边缘互相联结成网状花长约8毫米苞片披针形花冠黄色或金黄色旗瓣开展翼瓣与龙骨瓣分离长圆形或斜卵形花柱延伸于萼管咽部之外荚果膨胀荚厚68月花果期分布于巴西中国埃及等地落花生中国各地均有种植主要分布于辽宁山东河北河南江苏福建广东广西四川吉林等省区落花生的果实为荚果果壳的颜色多为黄白色也有黄褐色褐色或黄色的这与花生的品种及土质有关花生果壳内的种子通称为花生米或花生仁由种皮子叶和胚三部分组成种皮的颜色为淡褐色或浅红色种皮内为两片是生产食用植物油的原料花生果仁中提取油脂呈透明淡黄色味芳香种子含脂肪油4050含氮物质2030淀粉821纤维素25水分58灰分24维生素等1花生米可以加工成副食品概述图参考来源中国自然标本馆2
原因汉语词语读音为yunyn释义1指原来因为2指造成某种结果或者引发某种事情的条件1	准则汉语词语拼音是zhnz意思是准许的原则
委员会是由1政党团体机关学校中的集体领导组织如中国共产党中央委员会体育运动委员会校务委员会组成2机关团体学校等为了完成一定的任务而设立的专门组织如招生委员会伙食委员会管理委员会等3政党团体机关军事集体领导和组织如中华人民共和国中央军事委员会中国共产党中央军事委员会特例苏联内务人民委员会中华人民共和国国防委员会	推荐拼音为tujin汉语词语意思是推荐介绍建议最好去选择你看中的答案推举出自汉书王莽传上
霹雳布袋戏虚拟人物幽界魔仆之一在幽界具特殊地位即便是君临黑帝也要对其敬畏三分与魔仆运命谨守天职全力协助魔主在进入衰退期时以特殊方法吸收人间罪业以维持三茧之魔源借此度过衰退期1	元件产品系统在一定时间内在一定条件下无故障地执行指定功能的能力或可能性可通过可靠度失效率平均无故障间隔等来评价产品的可靠性
街道汉语词汇拼音jido释义供人车通行的道路	地方汉语词语拼音是dfngdfang一指地面的某一个特定地区一个特定的所在地点二指一个特定的地点三指各行政区四指部分五指地保的俗称1
视频Video泛指将一系列静态影像以电信号的方式加以捕捉记录处理储存传送与重现的各种技术连续的图像变化每秒超过24帧frame画面以上时根据视觉暂留原理人眼无法辨别单幅的静态画面看上去是平滑连续的视觉效果这样连续的画面叫做视频视频技术最早是为了电视系统而发展但现在已经发展为各种不同的格式以利消费者将视频记录下来网络技术的发达也促使视频的纪录片段以串流媒体的形式存在于因特网之上并可被电脑接收与播放视频与电影属于不同的技术后者是利用照相术将动态的影像捕捉为一系列的静态照片	档案是北京广播电视台推出的纪实栏目于2009年2月4日开播节目定位为演播室节目由一个特定的极具个性化的讲述者主持人现场讲述和展示为基本形态节目形式以案件和事件现场实录回放为线索首次披露国际国内大案要案社会传奇情感故事等其内涵深外延广节目贴近百姓生活紧跟时代脉搏展现人生百态透视社会万象百姓关心关注的热点是我们节目选题的目光指向更融合了国外最新传奇探索节目和国内栏目形式以前所未有的视觉冲击力和新奇特角度探索世界找寻那曾经的真实所在和鲜为人知的事实真相12
肥皂剧soapopera是从英语传至中文的外来词汇又称泡沫剧通常指一出连续很长时间的虚构的电视剧节目每周安排为多集连续播出因此又称系列电视连续剧因最初播放期间经常夹杂肥皂广告而得名一般称晚八点档的电视剧为肥皂剧例如超长韩剧现多指以家庭生活和爱情为主的电视剧1922年8月22日肥皂剧最早出现在美国的广播当中	歌剧英文opera意大利语opera是一门西方舞台艺术简单而言就是主要或完全以歌唱和音乐来交代和表达剧情的戏剧是唱出来而不是说出来的戏剧歌剧在17世纪即1600年前后出现在意大利佛罗伦萨源自古希腊戏剧的剧场音乐歌剧的演出和戏剧的所需一样都要凭借剧场的典型元素如背景戏服以及表演等
领土汉语词汇拼音lngt释义名在一国主权管辖下的区域包括陆地领水领海和领空	表面是一个汉语词语读音是biomin是指人或事物的外表最外层
发展是汉语词语拼音fzhn意思是事物从出生开始的一个进步变化的过程是事物的不断更新	议题是一个汉语名词拼音是yt一般指会议讨论的题目
美元UnitedStatesdollar货币缩写USDISO4217货币代码USD符号USA是美利坚合众国萨尔瓦多共和国巴拿马共和国厄瓜多尔共和国东帝汶民主共和国马绍尔群岛共和国密克罗尼西亚联邦基里巴斯共和国和帕劳共和国的法定货币流通的美元纸币是自1929年以来发行的各版钞票1792年美国铸币法案通过后出现当前美元的发行是由美国联邦储备系统控制自1913年起美国建立联邦储备制度发行联邦储备券现行流通的钞票中99以上为联邦储备券美元的发行主管部门是国会具体发行业务由联邦储备银行负责办理在二战以后欧洲大陆国家与美国达成协议同意使用美元进行国际支付此后美元作为储备货币在美国以外的国家广泛使用并最终成为国际货币1截止2021年12月16日晚10点里拉对美元汇率已经超过156创下新低2021年以来里拉对美元贬值幅度超过503	损失是一个汉语词汇读音为snsh指失去东西不会有补偿也指损毁丧失毁坏损失既可作动词也可作名词反义词是收益收获
精力是汉语词汇汉语拼音为jngl指的是精神和体力精神气力专心竭力语出汉书匡衡传衡好学家贫庸作以供资用尤精力过绝人	实验室是由中国内地女歌手粟丹创作的英文专辑并于2016年06月18日发行
消费者指的是不能利用无机物质制造有机物质的生物其不能直接利用太阳能来生产食物只能直接或间接地依赖于生产者所制造的有机物质的异养生物1消费者不仅对初级生产物起着加工再生产的作用而且许多消费者对其他生物种群起着重要的调控作用在生态系统物质循环和能量流动中也起着重要的作用促进了整个生态系统循环和发展维持着生态系统的稳定1	信心是指对行为成功及其相应事物的发展演化犹如预盼的信任程度而若只相对于行为信心亦可就定义为是对行为过程的反应信心表现为对实现行为任务目标成败的外在感知情绪反应外在意识信心表现间具有相互的统一谐调性其中任何一种表现都会成为其它两种表现的反映信心以对行为的心理作用效能程度从低到高可分为自我效能感集体效能感行为业绩感三个层次其中低层次的信心被包含于高层次的信心之中行为态度和行为信心在任务目标上的对立统一会形成个体的士气或称之为积极主动性1
媒体是2004年中国宇航出版社出版的图书作者是英霍利尔本书来自英国世界级科普大师的杰作这是一套针对时下年轻人热门话题的科普读物	交易是文化艺术出版社出版的图书作者是显晔著1
报告使用范围很广按照上级部署或工作计划每完成一项任务一般都要向上级写报告反映工作中的基本情况工作中取得的经验教训存在的问题以及今后工作设想等以取得上级领导部门的指导报告在已发布的党人大政府司法军队机关的公文处理规范中都规定了这个文种	收益是指就该财产收取天然的或法定的孳息收益权也可以依法律的规定或所有人的同意而归非所有人取得生产上或商业上的收入营业收入得到益处
亚西尔阿拉法特阿拉伯语1929年8月4日162004年11月11日全名拉赫曼阿卜杜勒拉乌夫阿拉法特古德瓦侯赛尼逊尼派穆斯林巴勒斯坦政治家军事家巴勒斯坦前总统1948年阿拉法特参加第一次阿以战争1950年进入开罗大学土木工程系学习并当选为巴勒斯坦学生联合会主席开罗大学毕业后进入埃及军事学院学习1956年在埃及参加第二次阿以战争1957年到科威特公共工程部任工程师1958年参与秘密筹建巴勒斯坦民族解放运动组织法塔赫及其军事组织暴风突击队1969年2月当选为巴勒斯坦解放组织执委会主席1971年兼任巴勒斯坦革命武装力量总司令1987年4月再次当选巴解执委会主席1989年4月在巴解组织中央委员会会议上当选为巴勒斯坦国总统1991年9月蝉联总统1994年5月被任命为巴自治领导机构主席1996年4月再次当选巴解组织执委会主席2004年11月11日在法国巴黎逝世1阿拉法特自青年时代起就投身于巴勒斯坦民族的解放事业为争取恢复巴勒斯坦人民合法的民族权利进行了长期不懈的斗争1993年与以色列签署奥斯陆协议而获得1994年的诺贝尔和平奖23	安德鲁杰克逊英语AndrewJackson1767年3月15日1845年6月8日16绰号老胡桃木英语OldHickory12美国第7任总统1829年3月4日1837年3月4日1美国民主党创建者杰克逊13岁时从军17岁时学习法律成为律师历任田纳西州联邦众议员参议员州高等法院法官等职1801年起为田纳西民兵少将1813年领导克里克战争从克里克人中强取大量土地1814年被任命为志愿军少将于次年的新奥尔良战役中力挫英军名声大振成为美国的战争英雄1818年率部开始塞米诺尔战争并借机强占西属佛罗里达使西班牙割让该地予美国后成为首任佛罗里达州州长1824年竞选美国总统落败1828年以民主党候选人身份再度竞选并成功当选美国第11届总统111832年连任总统1837年卸任后退居纳什维尔1845年在此病逝享年78岁杰克逊是美国第一位民主党总统在任内大力加强总统职权极力维护联邦的统一但其专制手腕也引发较大争议他颁布的印第安人迁移政策招致众多批评原住民称其为印第安杀手20在围绕着杰克逊和他的对立面展开全国性的政治斗争的同时美国两党制逐渐成型28因其对美国政治带来的巨大影响其供职总统的时期被历史学家称为杰克逊时代14而所带来的民主方式后来形成杰克逊主义或称杰克逊式民主16在1962年历史学家的投票排名中杰克逊名列32位总统中第6名也是6位接近伟大总统中的第1名38概述内图片来源白宫历史协会官网6
旅馆是指为旅客提供住宿饮食服务以至娱乐活动的公共建筑旅馆类型可分为旅游旅馆假日旅馆会议旅馆汽车旅馆和招待所等	预订汉语词语拼音是ydn指事先订约购买东西预先订租预先订阅订购
建筑创刊于1954年5月15日是由中华人民共和国住房和城乡建设部主管建筑杂志社主办的住房和城乡建设系统类型期刊1据2020年5月建筑期刊官网显示建筑编委会共有编委57人1据建筑2020年第9期期刊内页显示建筑编辑部共有责任编辑1人编辑2人法律顾问1人2据2020年5月25日中国知网显示建筑出版文献共20612篇总被下载845810次总被引16008次2019版复合影响因子为01302019版综合影响因子为00333据2020年5月25日万方数据知识服务平台显示建筑文献量为14292篇基金论文量为56篇被引量为16695次下载量为161794次根据2017年中国期刊引证报告扩刊版数据显示建筑影响因子为0324	世纪杂志是由中央文史研究馆上海市文史研究馆联合主办的综合性文史双月刊世纪的前身是上海市文史研究馆主办的上海文史1989年1月上海文史创刊内部发行半年刊1991年改为季刊1992年获公开出版发行其时著名作家记者翻译家中央文史研究馆馆长萧乾先生为加强全国文史研究馆系统间的交流合作推动文史研究积累史料弘扬民族优秀文化提议将上海文史改由中央文史研究馆与上海市文史研究馆联合主办后经国务院领导指示同意新闻出版总署批准1993年7月世纪在上海创刊2
实践是一个汉语词汇拼音shjin具体意思为1改造社会和自然的有意识的活动2实际去做履行3在核辐射防护中实践指增加辐射照射剂量的活动实践是人类自觉自我的一切行为内在意识本体与生命本体的矛盾是推动人类自我解放的根本矛盾其外在化为人类个体及组织阶级通过生产关系联系的整体对于自然及个体间或者集体关系阶级关系形成的解放活动实践只有在自觉的意识下才是人性的人格的即正所谓实践出真知	机构是汉语词汇拼音是jgu意思指由两个或两个以上构件通过活动联接形成的构件系统按组成的各构件间相对运动的不同机构可分为平面机构如平面连杆机构圆柱齿轮机构等和空间机构如空间连杆机构蜗轮蜗杆机构等按运动副类别可分为低副机构如连杆机构等和高副机构如凸轮机构等按结构特征可分为连杆机构齿轮机构斜面机构棘轮机构等按所转换的运动或力的特征可分为匀速和非匀速转动机构直线运动机构换向机构间歇运动机构等按功用可分为安全保险机构联锁机构擒纵机构等在运动链中如果将其中某一构件加以固定而成为机架则该运动链便成为机构机构是具有确定相对运动的构件组合它是用来传递运动和力的构件系统
志愿者是2012年由中国人民大学出版社出版的一本图书作者是美国作家马克A缪其克作者认为志愿动机与个人的主观状态他们的可用的资源等都有关系书中展示了志愿工作是如何受家庭关系学校和社区影响的这是国内第一部志愿服务研究学术译著对我国志愿者工作有极大地借鉴意义	座右铭是东汉崔瑗所作铭文全文共20句100字抒发了作者为人处世的基本态度和基本立场其中每两句构成一个意思而且这两句的意思往往又是相反相对甚至相矛盾的作者正是通过这种对立矛盾突出了主观选择的价值和意义反映了当时较为普遍的价值观念
百拼音bi为汉语一级通用规范汉字常用字9此字始见于商代甲骨文百从甲骨文以来就用作数词表示十个十又引申为百倍百也表示数目多后引申为所有的众多的18百在古代读入声今读bi不读b百色地名在广西旧读bs今读bis1012	百分数表示一个数是另一个数的百分之几也叫百分率或百分比百分数通常不会写成分数的形式而采用符号百分号来表示1
海岸是牛奶咖啡演唱的歌曲发行于2022年2月17日收录于同名专辑海岸中1	山是東京茶演唱的歌曲收录于2022年2月16日发行的专辑在山的那边
体验是一个汉语词语拼音是tyn一指亲身经历实地领会二指通过亲身实践所获得的经验三指查核考察出自朱子语类卷一一九讲论自是讲论须是将来自体验说一段过又一段何补体验是自心里暗自讲量一次体验到的东西使得我们感到真实现实并在大脑记忆中留下深刻印象使我们可以随时回想起曾经亲身感受过的生命历程也因此对未来有所预感	音乐是一种艺术形式和文化活动其媒介是按时组织的有规律的声波机械波的一种它的基本要素包括强弱调性时长音色等由这些基本要素相互结合形成音乐的常用的形式要素例如节奏曲调和声以及力度速度调式曲式织体等构成音乐的形式要素就是音乐的表现手段不同类型音乐可能会强调或忽略其中的某些元素音乐是用各种各样的乐器和声乐技术演奏分为器乐声乐例如不带乐器伴奏的歌曲以及将唱歌和乐器结合在一起的作品在最一般的形式中将音乐描述为一种艺术形式或文化活动包括音乐作品的创作歌曲曲调交响曲等表演对音乐的评价对音乐历史的研究以及音乐教学古希腊和印度哲学家将音乐定义为水平排列为旋律而垂直排列为和声的音调诸如各个领域的和谐和这就是音乐在我耳边之类的俗语指出了这样一种观念即音乐通常是有序且听起来很愉快的但是20世纪的作曲家约翰凯奇JohnCage以为任何声音都可以是音乐例如说没有噪音只有声音音乐的创作表现意义甚至定义都根据文化和社会背景而有所不同确实在整个历史中一些新的音乐形式或风格都被批评为非音乐包括1825年贝多芬的大赋格1900年代初的早期爵士乐和1980年代的硬核朋克1
食物是2020年西安出版社出版的图书作者是蔡娜	准备作者黛安娜塔文纳DianeTavenner译者和渊屠锋锋是2020年由中信出版社出版的书籍12
电话是由陈奂仁作词作曲陈冠希演唱的一首歌曲收录于专辑Transition中发行于2002年8月29日1	回话汉语词语拼音是huhu意思是答复的话多指由别人转告的口头的答复多指由别人转告的1
武器是2019年北京联合出版公司出版的图书1	秘密是2022年现代出版社出版的图书1
红利是指上市公司在进行利润分配时分配给股东的利润一般是每10股派发XX元股东在获得时还要扣掉上交税额普通股股东所得到的超过股息部分的利润称为红利普通股股东所得红利没有固定数额企业分派给股东多少红利则取决于企业年度经营状况的好坏和企业今后经营发展战略决策的总体安排在美国大多数公司发放现金红利数额约占公司税后净利的4060公司红利发放时间大都是按季度进行每一季度分发一次一定数量或一定比例的红利如果还有多余公司还可在某一时候追加发放	运算数学上运算是一种行为通过已知量的可能的组合获得新的量运算的本质是集合之间的映射一般说来运算都指代数运算它是集合中的一种对应对于集合A中的一对按次序取出的元素ab有集合A中唯一确定的第三个元素c和它们对应叫做集合A中定义了一种运算由这个运算可以得出两个运算就是把ab中的一个当作所求的而把c当作已知的这样得出的运算叫做原来运算的逆运算例如加法是已知ab求abc的运算那么已知a及c求b的运算或者已知b及c求a的运算就是加法的逆运算叫做减法
床一般在卧室宿舍病房旅馆等场所使用是满足人类日常睡眠的必需用品有的带有定时暖床体重记录监测床单固定睡眠监测等设计趋向智能旧时通常以木材为材料坚固实用现在也可用不锈钢金属为主要材料可以有效增加床的使用性能和寿命一般有几十个零件组成标配的以床头床架床尾床腿床板床垫电动推杆芯片护挡脚轮餐桌设备置物托盘为组件采用冲孔装配焊接压铆除锈喷塑等工艺具有阻燃防鼠防蛀耐用实用简约美观易清洁移动方便智能安全等特点人的三分之一的时间都是在床上度过的经过千百年的不断演化和改进设计除了满足常人睡觉还可以装上配套床垫体重监测仪气垫医疗康复设备尿袋隐形挂钩也可增加就餐电动起背定时翻身移动行走站立负压接尿坐躺取暖降温等其它功能即可满足常人睡觉也可满足儿童重症病人各种残障人士老年人医院病人居家医疗康复学习生活办公应急等各种需要床的样式有西式箱体床中式传统架子床简约架子床按材料分为铁床木床不锈钢床布艺床皮面床按形式分为平板床单人床上下铺双层床电动床双人床关节康复护理床电动起背床智能翻身护理床残障床四柱床儿童床病号床治疗床折叠床体重监测护理床按摩床电动站床气垫床日床等	壁柜cabinet又称内嵌壁柜是指住宅套内与墙壁结合而成的落地或悬挂贮藏空间壁柜是指在墙体上留出空间而成的橱也叫作壁橱如果你的房里没有充足的空间容得下全尺寸的壁橱那麽一只吊衣柜或许就够用了这些吊衣柜也有许多样式可供选择多数是松木与挑花心木制的传统型式它们的外表看起来像个带抽屉的普通衣柜然而一打开便显露出挂衣服的空间而且也有抽屉的安排
部分类术语是文献分类学中最高的分类等级总共四个部经部史部子部集部1	文化是一部由霍尔尼兹所著的书籍商务印书馆出版发行
对于判例必须分别来看在民法法系判例是非正式的法律渊源除了个别情况外理论上不承认判例具有约束力在普通法法系判例是正式的法律渊源即判例法公共政策是有关必须达到集体目的或目标的一种政治决定这种决定一般来说旨在改善经济政治或者社会的境况或旨在促进整个社会的某种集体目标的实现事物性质实际上是一种知识或人们对事物内在规律的认识1	信息指音讯消息通讯系统传输和处理的对象泛指人类社会传播的一切内容人通过获得识别自然界和社会的不同信息来区别不同事物得以认识和改造世界在一切通讯和控制系统中信息是一种普遍联系的形式1948年数学家香农在题为通讯的数学理论的论文中指出信息是用来消除随机不定性的东西创建一切宇宙万物的最基本单位是信息
基准是机械制造中应用十分广泛的一个概念机械产品从设计时零件尺寸的标注制造时工件的定位校验时尺寸的测量一直到装配时零部件的的装配位置确定等都要用到基准的概念基准就是用来确定生产对象上几何关系所依据的点线或面	在关系数据库中索引是一种单独的物理的对数据库表中一列或多列的值进行排序的一种存储结构它是某个表中一列或若干列值的集合和相应的指向表中物理标识这些值的数据页的逻辑指针清单索引的作用相当于图书的目录可以根据目录中的页码快速找到所需的内容索引提供指向存储在表的指定列中的数据值的指针然后根据您指定的排序顺序对这些指针排序数据库使用索引以找到特定值然后顺指针找到包含该值的行这样可以使对应于表的SQL语句执行得更快可快速访问数据库表中的特定信息当表中有大量记录时若要对表进行查询第一种搜索信息方式是全表搜索是将所有记录一一取出和查询条件进行一一对比然后返回满足条件的记录这样做会消耗大量数据库系统时间并造成大量磁盘IO操作第二种就是在表中建立索引然后在索引中找到符合查询条件的索引值最后通过保存在索引中的ROWID相当于页码快速找到表中对应的记录
玻璃是非晶无机非金属材料一般是用多种无机矿物如石英砂硼砂硼酸重晶石碳酸钡石灰石长石纯碱等为主要原料另外加入少量辅助原料制成的它的主要成分为二氧化硅和其他氧化物1普通玻璃的化学组成是Na2SiO3CaSiO3SiO2或Na2OCaO6SiO2等主要成分是硅酸盐复盐是一种无规则结构的非晶态固体广泛应用于建筑物用来隔风透光属于混合物另有混入了某些金属的氧化物或者盐类而显现出颜色的有色玻璃和通过物理或者化学的方法制得的钢化玻璃等有时把一些透明的塑料如聚甲基丙烯酸甲酯也称作有机玻璃	金属一般指具备特有光泽即对可见光强烈反射而不透明具有延展性及导热导电性的一类物质狭义的金属概念为由金属元素组成的单质4纯金属在常温下一般都是固体汞除外大多数为电和热的优良导体密度较大熔点较高1地球上的金属资源广泛地存在于地壳和海洋中除少数很不活泼的金属如金银等有单质形式存在外其余都以化合物的形式存在1金属在自然界中广泛存在在生活中应用极为普遍在现代工业中是非常重要和应用最多的一类物质
森林是2015年中国人口出版社出版的图书1	埋葬死人的地方坟地主要是指人去世后将遗体或骨灰式遗物统一集中到一个统一的地点这是人类发展历史上的文明和进步如今随着城市化的发展城市人口的增多公墓建设成为了城市发展的必然2018年9月7日民政部公布殡葬管理条例征求意见稿条例拟规定安葬骨灰的独立墓位占地面积不得超过05平方米1
音乐是一种艺术形式和文化活动其媒介是按时组织的有规律的声波机械波的一种它的基本要素包括强弱调性时长音色等由这些基本要素相互结合形成音乐的常用的形式要素例如节奏曲调和声以及力度速度调式曲式织体等构成音乐的形式要素就是音乐的表现手段不同类型音乐可能会强调或忽略其中的某些元素音乐是用各种各样的乐器和声乐技术演奏分为器乐声乐例如不带乐器伴奏的歌曲以及将唱歌和乐器结合在一起的作品在最一般的形式中将音乐描述为一种艺术形式或文化活动包括音乐作品的创作歌曲曲调交响曲等表演对音乐的评价对音乐历史的研究以及音乐教学古希腊和印度哲学家将音乐定义为水平排列为旋律而垂直排列为和声的音调诸如各个领域的和谐和这就是音乐在我耳边之类的俗语指出了这样一种观念即音乐通常是有序且听起来很愉快的但是20世纪的作曲家约翰凯奇JohnCage以为任何声音都可以是音乐例如说没有噪音只有声音音乐的创作表现意义甚至定义都根据文化和社会背景而有所不同确实在整个历史中一些新的音乐形式或风格都被批评为非音乐包括1825年贝多芬的大赋格1900年代初的早期爵士乐和1980年代的硬核朋克1	项目是人们通过努力运用各种方法将人力材料和财务等资源组织起来根据商业模式的相关策划安排进行一项独立一次性或长期无限期的工作任务以期达到由数量和质量指标所限定的目标叶圣陶倪焕之二五教育这个项目当然是不容轻易忽略的洪深戏剧导演的初步知识上篇二它们的式样大小制造的材料使用的方法等等项目繁多秦牧艺海拾贝核心生动的语言和丰富的词汇看来该是技巧性很强的一个项目了项目参数包括项目范围质量成本时间资源美国项目管理协会projectManagementInstitutePMI在其出版的项目管理知识体系指南ProjectManagementBodyofKnowledgePMBOK中为项目所做的定义是项目是为创造独特的产品服务或成果而进行的体系化的工作以下活动都可以称为一个项目1开发或运营一项产品2计划举行大型活动如策划组织婚礼大型国际会议等3策划一次自驾游旅游4ERP的咨询开发实施与培训5成立并运营一款子品牌
线是2018年世界图书出版西安有限公司出版的图书	保险是2004年科学出版社出版的作品作者是上山道生
精力是汉语词汇汉语拼音为jngl指的是精神和体力精神气力专心竭力语出汉书匡衡传衡好学家贫庸作以供资用尤精力过绝人	秘书是中国劳动社会保障出版社出版的图书作者是劳动和社会保障部教材办公室组织编写1
没有其他任何一种材料的适应力能比得上这种超级混合物玻璃在绝大多数工业领域都具有一席之地从交通包装到时装与饰物当它结合其他材料使用时玻璃丰富加强开阔的无尽的可能性从纯艺术到核心工业本书展示了一系列令人称奇的玻璃产品与应用实例这证明了一点从本质上限制这种材料的就是我们的想像力1	魔术师Magician或Illusionist另称魔力师是一类以表演魔术并使人见证不可思议之事的职业魔术师利用道具手法物理化学心理学等原理使不可能变为可能的表演过程这便是魔术Magic在表演过程中使用的工具便是道具道具中暗藏的构造和表演的本领便是魔术的秘密就广义的来说凡是呈现于视觉上不可思议的事都可称之为魔术而下工夫去学习让人们去观看这种不可思议的现象便是表演魔术魔术师的一个重要技法就是错误引导它是魔术师将观众注意力引至魔术师所欲之地方的一个重要技法英文称misdirection但其实错误引导的精髓在于引导direction引导观众的注意力思绪是魔术师操控人心的秘法也是魔术引人入胜的原因
海岸又称滨分为海岸湖岸及河岸是在水面和陆地接触处经波浪潮汐海流等作用下形成的滨水地带其中有众多沉积物堆积而形成的岸称为滩紧邻海滨在海滨向陆一侧包括海崖上升阶地陆侧的低平地带沙丘或稳定的植被地带指海滨或滨海的陆地边界紧接海洋边缘的陆地	林地是森林的载体是森林物质生产和生态服务的源泉是森林资源资产的重要组成部分森林法规定林地是指郁闭度02以上的乔木林地以及竹林地疏林地未成林造林地灌木林地采伐迹地火烧迹地苗圃地和县级以上人民政府规划的宜林地在进行经济效益评估时主要是对各类型林地面积及其价值进行评估12021年8月26日上午自然资源部召开新闻发布会公布第三次全国国土调查主要数据成果数据显示我国林地426亿亩2
延迟是指帧从网络上一个端口进入到从另一个端口出去所花费的时间可以通过使用加速器改善	新闻1也叫消息资讯是通过报纸电台广播电视台等媒体途径所传播信息的2一种称谓是记录社会传播信息反映时代的一种文体新闻概念有广义与狭义之分就其广义而言除了发表于报刊广播互联网电视上的评论与专文外的常用文本都属于新闻之列包括消息通讯特写速写有的将速写纳入特写之列等等3狭义的新闻则专指消息消息是用概括的叙述方式比较简明扼要的文字迅速及时地报道国内外新近发生的有价值的事实让别人了解每则新闻一般包括标题电头导语主体背景和结语六部分前四者是主要部分后二者是辅助部分标题导语主体必不可少写法上主要是叙述有时兼有议论描写评论等新闻是包含海量资讯的新闻服务平台真实反映每时每刻的重要事件可以通过查看新闻事件热点话题人物动态产品资讯等快速了解它们的最新进展4
比赛汉语词汇拼音bsi意思指在体育生产等活动中比较本领技术的高低	系列是汉语词语拼音xli是指相互关联的成组成套的事物或现象
对于判例必须分别来看在民法法系判例是非正式的法律渊源除了个别情况外理论上不承认判例具有约束力在普通法法系判例是正式的法律渊源即判例法公共政策是有关必须达到集体目的或目标的一种政治决定这种决定一般来说旨在改善经济政治或者社会的境况或旨在促进整个社会的某种集体目标的实现事物性质实际上是一种知识或人们对事物内在规律的认识1	法律是由国家制定或认可并以国家强制力保证实施的反映由特定物质生活条件所决定的统治阶级意志的规范体系1法律是统治阶级意志的体现法律是由享有立法权的立法机关行使国家立法权依照法定程序制定修改并颁布并由国家强制力保证实施的基本法律和普通法律总称法律是法典和律法的统称分别规定公民在社会生活中可进行的事务和不可进行的事务中国的法律可以划分为1宪法2法律3行政法规4地方性法规5自治条例和单行条例法律是从属于宪法的强制性规范是宪法的具体化宪法是国家法的基础与核心法律则是国家法的重要组成部分截至2019年11月中国现行有效的法律有275部2
注册是汉语词汇汉语拼音为zhc是把名字记入簿册多指取得某种资格也意为由主管部门办理手续记入籍册便于管理查考一般网络游戏注册需填写账号密码确认密码注册邮箱真实姓名身份证验证码同意用户协议	安排网络流行词本义指的是拜托或者处理的意思而在网络用语中安排是整人的意思2
龙虾TheLobster是歌手尹钟信演唱的歌曲现收录于20159专辑当中1	酒是老猫林妹妹演唱的歌曲由张世东作词孙勇作曲收录于2022年1月26日酒专辑中1
对于判例必须分别来看在民法法系判例是非正式的法律渊源除了个别情况外理论上不承认判例具有约束力在普通法法系判例是正式的法律渊源即判例法公共政策是有关必须达到集体目的或目标的一种政治决定这种决定一般来说旨在改善经济政治或者社会的境况或旨在促进整个社会的某种集体目标的实现事物性质实际上是一种知识或人们对事物内在规律的认识1	接收及征集档案和其他有关文献的活动1引自DLT13962014水电建设项目文件收集与档案整理规范
媒体media一词来源于拉丁语Medius意为两者之间媒体是传播信息的媒介它是指人借助用来传递信息与获取信息的工具渠道载体中介物或技术手段也指传送文字声音等信息的工具和手段也可以把媒体看作为实现信息从信息源传递到受信者的一切技术手段媒体有两层含义一是承载信息的物体二是指储存呈现处理传递信息的实体媒是女字旁诗卫风氓中有匪我愆期子无良媒古语又讲天上无云不下雨地上无媒不成婚可见很早之前媒主要是在男女婚嫁中起传情达意的中介作用1	增益的一般含义简而言之就是放大倍数在电子学上通常为一个系统的讯号输出与讯号输入的比率如天线增益表示定向天线辐射集中程度的参数为定向天线和无方向天线在预定方向产生的电场强度平方之比放大器增益表示放大器功率放大倍数以输出功率同输入功率比值的常用对数表示等
和平是2005年网络游戏劲乐团中的世界比赛曲目由Allo2SEo2SE全体成员创作	计划是罗密欧方程式中的纯音乐1
安排网络流行词本义指的是拜托或者处理的意思而在网络用语中安排是整人的意思2	住宿拼音zhs汉语词语意思是指过夜多指在外暂住1常见的住宿类型有酒店家庭客栈青年旅社民宿等
公告是指政府团体对重大事件当众正式公布或者公开宣告宣布国务院2012年4月16日发布2012年7月1日起施行的党政机关公文处理工作条例对公告的使用表述为适用于向国内外宣布重要事项或者法定事项其中包含两方面的内容一是向国内外宣布重要事项公布依据政策法令采取的重大行动等二是向国内外宣布法定事项公布依据法律规定告知国内外的有关重要规定和重大行动等	产品是指被人们使用和消费并能满足人们某种需求的任何东西包括有形的物品无形的服务组织观念或它们的组合产品一般可以分为五个层次即核心产品基本产品期望产品附加产品潜在产品核心产品是指整体产品提供给购买者的直接利益和效用基本产品即是核心产品的宏观化期望产品是指顾客在购买产品时一般会期望得到的一组特性或条件附加产品是指超过顾客期望的产品潜在产品指产品或开发物在未来可能产生的改进和变革产品是一组将输入转化为输出的相互关联或相互作用的活动的结果即过程的结果在经济领域中通常也可理解为组织制造的任何制品或制品的组合在现代汉语词典当中的解释为生产出来的物品简单来说是为了满足市场需要而创建的用于运营的功能及服务就是产品产品是以使用为目的物品和服务的综合体产品的价值是由用户来衡量的
开始是1999年丁薇演唱的一首歌曲收录于专辑开始中1	年是范晓萱作词Allen作曲范晓萱演唱的一首单曲
火星是2017年北京美术摄影出版社出版的图书作者是法弗朗西斯罗卡尔美阿尔弗雷德麦克伊文法沙维叶巴莱尔主要讲述了伴随着令人赞叹震撼的景象再深入了解火星观测与探测的悠远历史读者会不断刷新对火星的理解对天文的解读本书是一部开启科学探索精神的优秀之作1	水是2021年重庆出版社出版的图书作者是奥地利维罗妮卡斯特朗本书讲述了水在人类生活与文化中所具有的重要价值记录了人类与水相互作用之间的丰富历史分析了人类与水的关系1
原因是由易家扬作词冯翰铭作曲AlexTheInvisibleMen编曲余文乐的一首歌曲收录于专辑WhetherOrNot中发行于2005年10月21日	高血压是上海文化出版社出版的图书作者是刘建平主编1
重心作用凡人有四肢躯干头为首其站立俯仰亦各有姿势姿势立则生重心重心稳固所谓得机得势重心失中乃有颠倒之虞即不得机不得势也拳术功用之基础则在重心之稳固与否而重心又有固定与活动之分固定者是专主自己练习拳术之时每一动作一姿势均须时时注意之或转动或进退皆然重心与虚实本属一体虚实能变换无常重心则不然虽能移动因系全体之主宰不能轻举妄动使敌知吾虚实又如作战然心为令气为旗腰为纛太极拳以劲为战术虚实为战略意气为指挥听劲为间牒重心为主帅学者应时时揣摸默识体会之此为斯道全体大用也重心活动之谓系在彼我相较之间虽在决斗之中必须时时维持自己之重心而攻击他人之重心即坚守全军之司令而不使主帅有所失利也	此幅生活作于1903年所画的对象有着巴塞罗那时所见到的生活痕迹有1975129厘米大现藏美国克里夫兰艺术博物馆毕加索经历了前半个世纪现代流派各个方面的探索又经历了两次世界大战的生活考验他的艺术与政治信仰得到了磨炼从而为世界人民所尊重他从1891年开始学画经历了大部分的变形时代从立体主义开始包括分析性立体主义和综合性立体主义到表现主义超现实主义结构主义以至波普艺术无处没有染指而且随着生活与时势的变迁他经常在他所喜爱的流派实验中不断反复这一切说明了他那旺盛的不知疲倦的精力和崇尚时代潮流的性格特征
世纪是为中国共产党成立100周年深情献礼的大型原创交响芭蕾该舞蹈为5月23日于北京天桥剧场首演上演至5月30日1舞团试图以芭蕾这一国际艺术语汇融古汇今运用交响芭蕾的独特艺术表现形式配合恢弘壮美雄壮磅礴的交响音乐深情表现中华民族精神的当代传承讲述中国故事	国家是由青岛演艺集团出品青岛市歌舞剧院创排的民族歌剧12022年6月17日起启动青岛市巡演2
神圣词语拼音shnshng形容崇高尊贵庄严而不可亵渎	性为独立学者诗人作家国学起名师灵遁者的诗歌作品
词语是2018年有人出版社出版的图书作者是辛金顺1	相似度是由签约作家良九创作的网络小说发表于晋江文学网
星期三创刊于1933年由星期三周报社编辑发行位于上海陶尔斐司路四十一号每份三分五该刊的停刊时间和原因均不详馆中存有该刊前二十七期为其1933年10月发行的第一卷合订本	新闻1也叫消息资讯是通过报纸电台广播电视台等媒体途径所传播信息的2一种称谓是记录社会传播信息反映时代的一种文体新闻概念有广义与狭义之分就其广义而言除了发表于报刊广播互联网电视上的评论与专文外的常用文本都属于新闻之列包括消息通讯特写速写有的将速写纳入特写之列等等3狭义的新闻则专指消息消息是用概括的叙述方式比较简明扼要的文字迅速及时地报道国内外新近发生的有价值的事实让别人了解每则新闻一般包括标题电头导语主体背景和结语六部分前四者是主要部分后二者是辅助部分标题导语主体必不可少写法上主要是叙述有时兼有议论描写评论等新闻是包含海量资讯的新闻服务平台真实反映每时每刻的重要事件可以通过查看新闻事件热点话题人物动态产品资讯等快速了解它们的最新进展4
少数是许美静演唱的一首歌曲收录于专辑许美静宝丽金88音色系列中1	和平是2000年孙燕姿演唱的一首歌曲收录于专辑孙燕姿同名专辑
钱是1983年上映的美国剧情电影由罗伯特布列松执导克里斯琴佩蒂及马克厄恩斯特等主演钱讲述了一张500元法郎的假钞在很多人之间转手最后落到了一个叫伊文的年轻人手中在他使用这张钱时被发现并被捕入狱从而改变了他的命运	撤回是马克康恩执导编剧的一部剧情短片片长10分钟于2006年上映该短片获得了第60届戛纳电影节NFBOnlineShortFilmCompetition12
街道是由林俊杰演唱的歌曲由DrMoon和MrMars作词林俊杰作曲收录于林俊杰2008年10月18日发行的专辑JJ陆中该歌曲是电视剧爱情睡醒了的插曲	孩子是由歌手朱婧汐作词作曲并演唱的歌曲收录于EP她中是该EP的双主打歌之一于2013年11月25日发行12014年9月12日该曲又被朱婧汐收录于个人首张创作专辑以梦为马中22015年该曲获得2014年度广州新音乐十大金曲排行榜最佳MV金奖3
空间是2011年东南大学出版社出版的图书1	化学是2021年航空工业出版社出版的图书1
股票stock是股份公司所有权的一部分也是发行的所有权凭证是股份公司为筹集资金而发行给各个股东作为持股凭证并借以取得股息和红利的一种有价证券股票是资本市场的长期信用工具可以转让买卖股东凭借它可以分享公司的利润但也要承担公司运作错误所带来的风险每股股票都代表股东对企业拥有一个基本单位的所有权每家上市公司都会发行股票同一类别的每一份股票所代表的公司所有权是相等的每个股东所拥有的公司所有权份额的大小取决于其持有的股票数量占公司总股本的比重股票是股份公司资本的构成部分可以转让买卖是资本市场的主要长期信用工具但不能要求公司返还其出资1	电话英语Telephone出自希腊语tle意为远和phn意为声音旧译德律风是一种可以传送与接收声音的远程通信设备早在18世纪欧洲已有电话一词用来指用线串成的话筒以线串起杯子电话的出现要归功于亚历山大格拉汉姆贝尔早期电话机的原理为说话声音为空气里的复合振动可传输到固体上通过电脉冲于导电金属上传递这一行业通常分为电话设备制造商和电话网络运营商在历史上网络运营商通常都拥有全国性的垄断随着全球电信市场的开放和集成以及技术的发展逐渐出现多家运营商在同一市场竞争的局面例如贝尔系统即ATampT的下属公司曾拥有美国电话市场的80
国王简称王是国际象棋中的一种棋子英文为king是决定胜负的棋子也是双方在棋盘上争夺的目标与中国象棋的将帅类似一旦国王被对方棋子吃掉或者国王无法摆脱对方棋子的攻击范围就算输棋国王是国际象棋中最重要的棋子国际象棋的最终目标就是吃掉对方的国王以及保护自己的国王不被对方吃掉	中国象棋以及国际象棋的一种棋子国际象棋称其为城堡在二者中走法极其相似中国古代四人二马的战车为一车音j在国际象棋中原意为Rook城堡
五汉语常用字1读作w最早见于甲骨文2其本义为金木水火土等宇宙的构成要素代表天地间万物构成元素的极限数大于四小于六后引申为古代军队编制单位工尺谱中的音名之一等3基本信息栏参考资料4	月汉语常用字1读作yu最早见于商代甲骨文2其本义是地球的天然卫星即月亮古人根据月亮的盈亏规律创造了月这个计时单位沿用至今也指形状像月亮的东西按月出现或完成等义3月是常见偏旁以月为偏旁的字一类与月亮有关如朔望朝等还有一类是由肉演变而来与月亮无关如肘肚肺肥等基本信息栏参考资料4
歌剧Opera是用声乐和器乐表现剧情的戏剧作品是音乐与诗歌戏剧表演舞蹈舞台美术服装等结合为一体的综合性艺术体裁12歌剧的结构通常包括序曲间奏曲合唱重唱独唱等歌剧中主角的独唱又分为咏叹调宣叙调还有小咏叹调咏叙调卡伐蒂娜浪漫曲与小夜曲等1	工业是对自然资源开采和对各种原材料加工的社会物质生产部门工业industry是社会分工发展的产物经过手工业机器工业等几个发展阶段是第二产业的主要组成部分分为轻工业和重工业两类2014年中国工业生产总值达4万亿美元超过美国成为世界头号工业生产国1
试图是由陆逸杰演唱的一首歌曲发布于2021年10月23日1	和平收录于英皇娱乐发行于2005年9月30日的苏醒专辑中由竹子作词王杰札西棋连作曲RickyHo编曲该曲演唱者为王杰12
糖是游戏Minecraft中的一种材料1除了作为用途广泛的合成材料还可以用于动物的繁殖和恢复2	方法是一个汉语词汇方法的含义较广泛一般是指为获得某种东西或达到某种目的而采取的手段与行为方式方法在哲学科学及生活中有着不同的解释与定义4
调查是2014年上海译文出版社出版的一部图书作者是法克洛代尔2	努力是北方文艺出版社出版的图书作者是张一一著1
公告是指政府团体对重大事件当众正式公布或者公开宣告宣布国务院2012年4月16日发布2012年7月1日起施行的党政机关公文处理工作条例对公告的使用表述为适用于向国内外宣布重要事项或者法定事项其中包含两方面的内容一是向国内外宣布重要事项公布依据政策法令采取的重大行动等二是向国内外宣布法定事项公布依据法律规定告知国内外的有关重要规定和重大行动等	努力汉语词语拼音nl释义尽力的使出自己的力气来做事努力指用尽力气去做事情后来指一种做事情的积极态度比如说努力干活努力学习
美洲虎JAGUAR是英国轿车的一种名牌产品	汽车是北京科学技术出版社出版的图书作者是英格雷厄姆著1
到达是中央广播电视总台出品的首部抗疫题材电视系列剧最美逆行者1000公里篇章的主题曲由张筱真作曲李玉飞作词王晰演唱1到达MV版同期上线23	旅馆是由王小帅执导宁元元黄小蕾戴军等主演的电影于2022年5月19日在戛纳电影节上映2该片讲述了疫情下被困在幽闭恐惧环境中的人们面临着封锁宵禁和隔离以及命运和人性残酷考验的故事1
方向男汉族民盟盟员安徽深蓝芜湖律师事务所律师2	动词释义人或事物间发生密切联系理论实际指结为夫妻词语分开解释结结结ji系j绾w僴结网结绳结扎条状物打成的疙瘩打结蝴蝶结合合h闭对拢合眼珠联璧合貌合神离聚集合力合办合股合资不违背
利润是汕头大学出版社出版的图书作者是美卡伍德博士美贝莉著1	警告是由阿加塔亚历山大执导安娜贝拉沃丽丝爱丽丝伊芙主演的科幻惊悚片该片讲述了在将来的地球上探讨孤独死亡和生命的意义的故事该片于2021年10月22日在美国上映
尺寸是一款新型的购物软件它拥有了全球独立设计师优质的时尚专栏国际化的时尚买手团队同步全球时尚秀场等品牌特色是一个融入了艺术设计生活元素的时尚概念买手店	突出tch引申指作家在构思时从纷繁复杂的思绪中紧紧抓住一个形象或意念并调动各种材料和加工手段为其服务尽量使其比周围其他形象更明确清晰和与众不同
棒球是吉林出版集团有限责任公司出版的图书作者是岳言等1	季节1是邢翥1创作的一首诗歌
僧侣Monk是英雄无敌系列游戏中登场较晚的人类单位也是在系列作品中相当短命的一个单位在英雄无敌3中设定为城堡阵营的未升级五级单位也有版本译作牧师升级后即为祭司其实英文名词Zealot是狂热者在四代继续被沿用但是到了五代就被改成了牧师Priest最大的共同点定位都是远程攻击的神职单位值得一提的是即使到了五代这个单位的性价比都不怎么样所以六代干脆把这个定位的单位彻底改成女神官系列纯粹走了辅助和治疗路线连远程射击都省了	奴隶通常指失去人身自由并被他人任意驱使的为他们做事的人奴和隶这两种奴隶名称在先秦时代都已存在世界历史上人们因为战争犯罪破产等原因成为奴隶在成为劳动工具的同时也被当成一种有价值的货物进行赠赐与交易奴隶可以通过逃亡赎身立功等行为重新成为自由人历史上比较著名的奴隶有斯巴达克斯随着社会进步时代的发展奴隶范畴已经远远摆脱了先前的原始定义渐渐的引申为受制于某种事物或者行为使得自己丧失了独立自主自由支配的能力活在一个被奴役的生活之中
七汉语一级字1最早见于甲骨文七本义为切断早在商代甲骨文中七就借为数词本义则淹没不闻由数词七引申出与此相关的一些义项如七体指汉赋中一种以七段问答为主题的文学样式按阴阳学说七是由阳转阴的分界故人死后每七天一祭俗称七至七七四十九日称为满七2基本信息栏参考资料3	系列是汉语词语拼音xli是指相互关联的成组成套的事物或现象
情况是一个名词读音为qngkung是指情形情景出自堕及妻赵氏墓志情况也有指事情的来龙去脉等意思	隔离汉语词语拼音是gl意思是指断绝接触断绝往来隔断1出自阿房宫赋
月是2009年5月1日上海人民出版社出版的一部安妮宝贝写的中篇小说这是一段关于寻找的旋律	旅馆是2020年中国工人出版社出版的图书作者是卡罗琳菲尔德利万德1
对于判例必须分别来看在民法法系判例是非正式的法律渊源除了个别情况外理论上不承认判例具有约束力在普通法法系判例是正式的法律渊源即判例法公共政策是有关必须达到集体目的或目标的一种政治决定这种决定一般来说旨在改善经济政治或者社会的境况或旨在促进整个社会的某种集体目标的实现事物性质实际上是一种知识或人们对事物内在规律的认识1	组是用户或用户帐户的集合通过建立组可以简化对大量用户进行管理和确定权限的任务直接把消息发给组显然比把消息分发给组中每个用户容易组的作用是简化了管理的难度便于集中进行通知且不会让某些个体错过重要的信息除此之外组的作用可以让个体更加具备凝聚力组的应用便于进行批量化的操作向着整体的目标进行推进
tabulatearrangeincolumnsortables把制成表以表显示英文解释listlistfilesoftype以表格为容器装载着文字或图表的一种形式叫列表在互联网发展的同时还衍生了一种在以网上形式发表的列表简称网表	接近是陈慧娴与张学友对唱的无数歌曲中唯一的一首电视剧主题曲为1997年TVB茶是故乡浓的主题曲歌曲被演绎得非常完美有点遗憾的是陈慧娴没有出演MV
公鸡是一种家禽品种很多翅膀短不能高飞啼声能报晓公鸡是法国的国鸟原因是由于它那英勇顽强好斗的性格	指飞机的续航距离船舶中途不补充燃料可以运行的最大距离
伤心签名是一首黄乙玲演唱的歌曲由武雄作词深白色作曲收录于甲你作伴专辑中1	暂停是由唐思淼作词戴盡欢作曲小田音乐社尹昔眠演唱的歌曲发行于2021年8月27日收录于同名专辑暂停中1
股票stock是股份公司所有权的一部分也是发行的所有权凭证是股份公司为筹集资金而发行给各个股东作为持股凭证并借以取得股息和红利的一种有价证券股票是资本市场的长期信用工具可以转让买卖股东凭借它可以分享公司的利润但也要承担公司运作错误所带来的风险每股股票都代表股东对企业拥有一个基本单位的所有权每家上市公司都会发行股票同一类别的每一份股票所代表的公司所有权是相等的每个股东所拥有的公司所有权份额的大小取决于其持有的股票数量占公司总股本的比重股票是股份公司资本的构成部分可以转让买卖是资本市场的主要长期信用工具但不能要求公司返还其出资1	美洲豹学名PantheraoncaLinnaeus1758又叫美洲虎是现存第三大的猫科动物体重35150千克最大亚种雄性亚马孙美洲豹平均体重为98千克咬力可达1250磅是生活在中南美洲的一种大型猫科动物它身上的花纹比较像豹但整个身体的形状又更接近于虎在猫科动物中美洲豹的体型仅次于狮虎野外寿命约18年人工饲养的历史达20多年列入世界自然保护联盟濒危物种红色名录IUCN2021年近危NT
教授小说作品作者河冰为2019年度莽原文学奖的获奖作品1	黄瓜是烽火戏诸侯所著网络小说雪中悍刀行的角色1
延迟是指帧从网络上一个端口进入到从另一个端口出去所花费的时间可以通过使用加速器改善	种族主义Racialism是一种自我为中心的态度认为种族差异决定人类社会历史和文化发展认为自己所属的团体例如人种民族或国家优越于其他的团体种族主义起源于19世纪末列强瓜分非洲的年代当时非洲的资源被大量掳掠到欧美各国包括人力资源这些人被当作奴隶售卖
