中国国家最新标准汽车和挂车类型的术语和定义GBT373012001中对汽车有如下定义由动力驱动具有4个或4个以上车轮的非轨道承载的车辆主要用于载运人员和或货物牵引载运人员和或货物的车辆特殊用途国产汽车品牌有集度五菱宝骏红旗长安长城奇瑞吉利荣威比亚迪蔚来小鹏汽车东风等国外汽车品牌有丰田大众奥迪奔驰现代起亚标致凯迪拉克日产等	轿车salooncar是指用于载送人员及其随身物品且座位布置在两轴之间的汽车包括驾驶者在内座位数最多不超过九个一般轿车强调的是舒适性以乘员为中心而且是从经济性考虑出发选择马力适中排量小耗油量小的发动机在中国内地的行驶证管理方面轿车特指区别于货车皮卡SUV大巴中巴的小型汽车俗称为小轿车在香港轿车又称私家车
珠宝是2019年中国林业出版社出版的图书1	宝石是2015年现代出版社出版的图书1
旅行郭飞宏演唱的歌曲1	航行hngxng船在水里或飞机在空中行驶
男孩是网剧灵魂摆渡中的角色由段少男扮演1	少年网剧灵魂摆渡中的角色由马可扮演1
海岸是高珊演唱的歌曲收录于2019年10月22日专辑海岸中1	岸是由杨光煜演唱的歌曲该曲收录于杨光煜发行的同名专辑岸中1
避难所是开发商MightandDelight公司开发的一款角色扮演游戏	疯人院是一款独特的FPS游戏它是根据一部同名小说改编的该小说由苏格兰邪教作家克里斯托弗布鲁克梅尔ChristopherBrookmyre创作Bedlam是为那些在80年代和90年代的网络游戏中幸存下来的人设计的射击游戏它以最新的图形和游戏功能来展现网络游戏中一个标志性的时代并提供一些真实的游戏怀旧疯人院完全以第一人称为背景但将从第一人称的角度探索其他游戏类型
月暗Moondark即魔术师Magician是美国漫威漫画旗下超级反派初次登场于漫威漫画团队MarvelTeamup第12期1978年3月是一名邪恶的魔术师月暗Moondark先后和蜘蛛侠SpiderMan恶灵骑士GhostRider还有暗夜狼人WerewolfbyMidnight等英雄交锋1	巫师Wizard是美国漫威漫画旗下超级反派初次登场于奇异故事StrangeTales第102期1962年11月本名宾利惠特曼BentleyWittman是一名天才发明家也是恐惧四魔FrightfulFour的创造者
中午又名正午指二十四小时制的1200或十二小时制的中午12时左右为一天的正中太阳在子午线上方时1	正午指中午十二点钟左右出自夏日途中
熔炉是1950年9月光明书局出版的图书作者是朱雷	火炉是供取暖和炊事用的炉子火炉也指夏季炎热城市新四大火炉排名来自近几十年的数据和资料分别是重庆福州杭州南昌
食物是2019年浙江教育出版社出版的图书	水果是2019年陕西人民教育出版社出版的图书1
鸟是现代叶永青创作的一幅油彩画	雄鸡是李斛20世纪60年代创作的纸本水墨设色中国画1
鸟汉语常用字1读作nio或者dio最早见于甲骨文2其本义为长尾飞禽后引申为能飞的昆虫地名等3基本信息栏参考资料4	鹤汉字一级字1读作h形声字最早见于说文小篆2其本义是鹤科各种类鸟的统称皆为大型涉禽全身白色或灰色生活在水边吃鱼昆虫或植物信息栏使用参考资料2
器械汉语词语泛指工具也指武器	工具是汉语词汇拼音是gngj意思是原指工作时所需用的器具后引申为达到完成或促进某一事物的手段
兄弟是LoredanaDordi执导EnzoCosimi米姆西法默主演的一部电影1	僧侣是多米尼克摩尔执导的悬疑片文森特卡索和黛博拉弗朗索瓦出演该片讲述了一位布道者相信自己不会被任何欲望诱惑而一名新来的女孩动摇了他的信念使他走上触犯原罪的道路的故事
歌曲兄弟由歌手张巍作词作曲并演唱发行于2019年1	少年是由李荣浩作词作曲并演唱的歌曲收录于2017年11月17日发行的专辑嗯中
1词语吊车即起重机拼音qzhngj解释提起或移动重物用的机器种类很多用于车间仓库码头车站矿山建筑工地等也叫吊车	器械汉语词语泛指工具也指武器
轿车是2015年吉林出版集团有限责任公司出版的图书该书讲述了关于轿车的贴纸游戏的内容	旅行是2016年上海三联书店出版的图书这本书讲述了一个富有通话趣味的关于小鸭子的童话故事
僧侣指和尚也借称古印度婆罗门教中世纪天主教等的修道者	圣贤指品德高尚有超凡才智的人通常是指被认为实践了儒学生命价值观的贡献历史和社会的人物圣贤的地位其实是由历代学者通过史书和官方祭祀制度确认的而非个人的认同如既加冠益慕圣贤之道明宋濂送东阳马生序
陵园属墓地的一种安葬形式类型随着时代的发展现代的陵园建设要求向着景观化艺术化立体化个性化产业化的方向迈进中国的墓园在景观方面自古受中国传统封建等级制度的影响没能体现出中国的山水园林风格在墓地的规划布局上非常严谨中国历代帝王和臣民的陵墓规模和形式绝不相同帝王陵墓规模宏伟坚固耐久构筑精美所选的地理位置和环境也是景色幽雅风景别致1	林地是森林的载体是森林物质生产和生态服务的源泉是森林资源资产的重要组成部分森林法规定林地是指郁闭度02以上的乔木林地以及竹林地疏林地未成林造林地灌木林地采伐迹地火烧迹地苗圃地和县级以上人民政府规划的宜林地在进行经济效益评估时主要是对各类型林地面积及其价值进行评估12021年8月26日上午自然资源部召开新闻发布会公布第三次全国国土调查主要数据成果数据显示我国林地426亿亩2
食物是1993年上映的捷克斯洛伐克电影由杨史云梅耶导演BedrichGlaserLudvkSvb主演	公鸡是1990年由申承秀导演的韩国电影1
海岸又称滨分为海岸湖岸及河岸是在水面和陆地接触处经波浪潮汐海流等作用下形成的滨水地带其中有众多沉积物堆积而形成的岸称为滩紧邻海滨在海滨向陆一侧包括海崖上升阶地陆侧的低平地带沙丘或稳定的植被地带指海滨或滨海的陆地边界紧接海洋边缘的陆地	基本概述马骝山位于河北省海兴县马骝山南望齐鲁东临渤海北倚京津距沧州大港20公里位于海兴县城东5公里马骝山又名小山形成于23万年第四纪晚期火山喷发是九河下梢入海处及九河文化的交汇点是由火山多期喷发堆积而成是渤海盆地断裂活动最直接的证据其典型性多样性和自然性实属平原地区独有国内罕见是具有重大科学价值和社会价值的地质遗迹区在小山附近先后挖掘出了大量古文物及化石对研究古代历史文化提供了重要参考价值亦留下了一个个凄美动听的故事山下纵横交错的古栈道甘甜可口的官井水能治病的小山沙茂盛的植物被及原有古塔古墓古寺庙等无一不诉说着小山的神秘
森林是2015年中国人口出版社出版的图书1	埋葬死人的地方坟地主要是指人去世后将遗体或骨灰式遗物统一集中到一个统一的地点这是人类发展历史上的文明和进步如今随着城市化的发展城市人口的增多公墓建设成为了城市发展的必然2018年9月7日民政部公布殡葬管理条例征求意见稿条例拟规定安葬骨灰的独立墓位占地面积不得超过05平方米1
岸是胡星冉演唱的歌曲由张鹏鹏作词郑国锋作曲邱凯辉编曲发行于2022年6月17日1	林地男汉族1967年5月出生1990年9月参加工作1992年3月加入中国共产党大学学历哲学学士学位林地现任葫芦岛日报社总编辑党委委员
僧侣Monk是英雄无敌系列游戏中登场较晚的人类单位也是在系列作品中相当短命的一个单位在英雄无敌3中设定为城堡阵营的未升级五级单位也有版本译作牧师升级后即为祭司其实英文名词Zealot是狂热者在四代继续被沿用但是到了五代就被改成了牧师Priest最大的共同点定位都是远程攻击的神职单位值得一提的是即使到了五代这个单位的性价比都不怎么样所以六代干脆把这个定位的单位彻底改成女神官系列纯粹走了辅助和治疗路线连远程射击都省了	奴隶通常指失去人身自由并被他人任意驱使的为他们做事的人奴和隶这两种奴隶名称在先秦时代都已存在世界历史上人们因为战争犯罪破产等原因成为奴隶在成为劳动工具的同时也被当成一种有价值的货物进行赠赐与交易奴隶可以通过逃亡赎身立功等行为重新成为自由人历史上比较著名的奴隶有斯巴达克斯随着社会进步时代的发展奴隶范畴已经远远摆脱了先前的原始定义渐渐的引申为受制于某种事物或者行为使得自己丧失了独立自主自由支配的能力活在一个被奴役的生活之中
海岸是由KD演唱作词作曲雨胜编曲的歌曲发行于2022年8月31日1	森林是由Mj谭杰明作词AlanPo布志纶作曲Mr演唱的一首歌曲收录于专辑IfIAm中发行于2009年09月03日
秘岸是由星皓电影有限公司出品的剧情影片该片由张一白担任编剧并执导莫文蔚曾志伟陈奕迅檀健次蒋雯丽等主演于2009年10月13日在中国内地上映1该片讲述了一个少年青春迷失的秘密一个家庭爱恨交织的秘密这一系列秘密结出一个隐秘的果实就是少年最终的破茧成蝶1	巫师是一部由MarcoKalantari执导的短片该片由DannyShaylerDavidSayers担任主演于2015年4月18日上映1
弦是由乔米儿作词作曲童珺演唱的歌曲发行于2020年12月19日1收录于同名专辑弦中	微笑是车行作词尹铁良作曲由于文华演唱的一首歌曲收录于2001年1月8日发行的专辑微笑中1
没有其他任何一种材料的适应力能比得上这种超级混合物玻璃在绝大多数工业领域都具有一席之地从交通包装到时装与饰物当它结合其他材料使用时玻璃丰富加强开阔的无尽的可能性从纯艺术到核心工业本书展示了一系列令人称奇的玻璃产品与应用实例这证明了一点从本质上限制这种材料的就是我们的想像力1	魔术师Magician或Illusionist另称魔力师是一类以表演魔术并使人见证不可思议之事的职业魔术师利用道具手法物理化学心理学等原理使不可能变为可能的表演过程这便是魔术Magic在表演过程中使用的工具便是道具道具中暗藏的构造和表演的本领便是魔术的秘密就广义的来说凡是呈现于视觉上不可思议的事都可称之为魔术而下工夫去学习让人们去观看这种不可思议的现象便是表演魔术魔术师的一个重要技法就是错误引导它是魔术师将观众注意力引至魔术师所欲之地方的一个重要技法英文称misdirection但其实错误引导的精髓在于引导direction引导观众的注意力思绪是魔术师操控人心的秘法也是魔术引人入胜的原因
公鸡是1990年由申承秀导演的韩国电影1	航行hngxng船在水里或飞机在空中行驶
正午指中午十二点钟左右出自夏日途中	串chun从二中连贯丨下上通于口指向于内种子生根发芽是中之范式种子连贯是串之范式本义多个同类东西连贯在一起如串讲贯串1衍义引申指连贯起来的东西如串珠串铃2衍义引申指错误地连接如串行hng串味串换3衍义引申指互相勾通勾结如串气串供串通一气4衍义引申指由这里到那里走动如串乡串门儿5衍义引申指扮演戏剧角色如串演客串6衍义用作量词用于连贯起来的东西如一串儿葡萄7衍义又用作姓8
